霍奇金［何杰金］病未特指C819	未特指的霍奇金病	1
移植肾慢性排异反应伴有部分肾坏死	肾移植排斥	1
周围神经病(？)	多发性神经病[多发性神经炎/周围神经炎]	1
宫颈上皮内病变Ⅲ级累及腺体	子宫颈上皮内瘤变III级[CINIII级]	1
5.右侧输尿管结石并右肾积水	肾积水伴输尿管结石	1
有放疗指征择期放疗	放射治疗	1
单纯疱疹病毒感染症	单纯疱疹	1
乙状结肠造口状态	结肠造口状态	1
双手麻木原因末梢神经病	末梢神经病[末梢神经炎]	1
颈动脉粥样硬化(混合斑)	颈动脉粥样硬化	1
左肺上叶舌段局部肺组织膨胀不全	肺不张	1
口唇干燥	口干	1
心肌桥左室舒张功能减低	冠状动脉肌桥	1
脊柱病除外后颅窝病变	脊椎病	1
脐部窦道	脐窦	1
狼疮肾LN-IVV复发治疗后复诊	狼疮性肾炎	1
回肠造口术状态	回肠造口状态	1
腹部神经性异常感觉	周围神经系统和特殊感觉功能检查的异常结果	1
左右侧颈动脉软斑及右侧锁骨下动脉混合斑	锁骨下动脉斑块	1
右耳听力重度障碍左耳听力中度障碍	听功能障碍	1
绝经前后诸症手麻手痒眼干	干眼症	1
巨大胎儿	巨大儿	1
左上肺碘125放射性粒子植入术	放射治疗	1
肝左内叶胆囊窝旁低密度影考虑小囊肿	肝囊肿	1
前降支肌桥重度	冠状动脉肌桥	1
完全性肺静脉异位引流心上型伴梗阻	完全性肺静脉异位引流,心上型	1
左胫骨平台开放性粉粹性骨折伴骨质部分缺损	胫骨骨折	1
左肩背部皮脂腺囊肿	皮脂腺囊肿	1
真菌败血	真菌性败血症	1
右肱二头肌肌腱脱位	肌腱滑脱	1
胸腹部及会阴部烫伤　Ⅰ°-浅Ⅱ° TBSA 6%	会阴烫伤	1
急性T淋巴细胞白血病L3型（中危，完全缓解期）	急性淋巴细胞白血病L3	1
胸12椎体陈旧性病变	脊椎病	1
B超提示胎儿卵圆孔稍增大肾窦分离	卵圆孔未闭	1
副乳腺	副乳	1
腰椎侧凸	腰椎侧弯	1
血小板减少查因:妊娠相关性	妊娠合并血小板减少	1
心脾肺虚血脂高	高脂血症	1
迁肝	慢性迁延性肝炎	1
先天性双侧髋关节错位	先天性髋关节脱位	1
宫颈II级	宫颈上皮瘤样病变[CIN]II级	1
左肺静脉栓塞	静脉栓塞	1
妊娠40周，孕1产0，LOP，单活胎	孕40周	1
短暂性缺血性脑血管疾病	脑血管供血不足	1
D1萌出乳牙未脱落	乳牙滞留	1
左侧室旁脱髓鞘左侧颞前小囊肿	脱髓鞘性脑病	1
慢性心能不全心功能II-III级	心功能Ⅱ--Ⅲ级(NYHA分级)	1
再次心内电生理检查及射频消融后	射频消融术后	1
2慢性肾脏疾病CKD3级	慢性肾脏病,3期	1
双侧胸腔积液伴肺膨胀不全	胸腔积液	1
尿路结石术后	未特指的泌尿系结石	1
右肘肱骨外髁骨不连	肱骨骨折不连接	1
早孕宫内或宫外尚无法确定	妊娠状态	1
慢性风湿性瓣膜疾病	风湿病	1
（左肾）符合重复肾	重复肾	1
牙龈损伤	牙及相关组织损伤	1
右中叶支气管粘膜白斑样病变	白斑病,不可归类在他处者	1
眼睑皮肤外伤	眼睑和眼周区其他浅表损伤	1
陈旧性虹膜炎	虹膜炎	1
颅高压综合症	颅内压增高	1
右肘关节肱骨滑车撕脱性骨折	肱骨滑车骨折	1
放射碘后胫前病变眼病	放射性损害	1
蝶鞍区脑膜良性肿瘤	脑膜良性肿瘤	1
肾错构瘤左侧	肾错构瘤	1
F1胎儿宫内生长受限伴多发结构异常	胎儿生长受限	1
右下肺斑片影性质待查早期恶性不除外	右肺下叶恶性肿瘤	1
上腹痛待查；消化道出血;	上腹痛	1
高血压3期	高血压	1
臀部皮脂腺囊肿	皮脂腺囊肿	1
颈肌筋膜炎	筋膜炎	1
停经285周41单胎高龄妊娠胎儿NT增厚	妊娠状态	1
右侧颊粘膜病变	口腔粘膜其他和未特指的损害	1
G4P2孕39周已产LOA	正常分娩	1
(宫颈CINI)	子宫颈上皮瘤样病变[CIN]I级	1
脂肪过多	脂肪过多症	1
骨髓穿刺组织示嗜酸性造血细胞轻度增生	嗜酸粒细胞增多	1
不全性流产	未特指的流产,不完全性,无并发症	1
鼻窦疾病待查	鼻和鼻窦其他特指的疾患	1
颅内多发轻度动脉狭窄伴斑块形成	动脉狭窄	1
肢体擦伤伴异物	开放性损伤伴异物	1
双膝关节骨关节炎	双侧膝关节骨性关节病	1
慢性支气管炎行动不便	慢性支气管炎	1
退变的骨组织伴灶性坏死及纤维化	骨坏死	1
停经202周B超提示胎儿右侧胸腔异常回声	妊娠状态	1
功能(障碍)性子宫出血	功能性子宫出血	1
胎儿生长发育受限刘鹤莺	妊娠状态	1
肠梗阻治疗后	肠梗阻	1
鼻背部色斑	色素斑	1
手指麻木原因待查多发性周围神经病可能性大	多发性神经病[多发性神经炎/周围神经炎]	1
二性症发育不佳	第二性征发育不全	1
肝外胆管扩张	胆管扩张	1
心脏起搏器安装术后	具有心脏起搏器状态	1
舌静脉畸形	舌血管畸形	1
右腋下皮脂腺囊肿待病理	皮脂腺囊肿	1
脑硬变早老性阿尔海茨海默	阿尔茨海默病(老年前期型)	1
停经294周B超提示胎儿左侧胸前增强回声	妊娠状态	1
左小腿筋膜间室综合症	下肢骨筋膜室综合征	1
VINIII级	阴道上皮内瘤变III级[VAINIII级]	1
颅内静脉窦血栓形成(治疗后)	非化脓性颅内静脉窦血栓形成	1
CAD血压病	高血压	1
右手骨关节炎	骨关节病	1
骶管小囊肿	椎管内囊肿	1
重度颅脑外伤性	头部损伤	1
慢性移植物抗宿主反应病口腔皮肤眼	慢性移植物抗宿主病	1
面部皮炎	皮炎	1
2.颈部硬膜外出血	硬膜外出血	1
胰腺特指疾病胰体良性病变	胰腺其他特指的疾病	1
左耳化脓性中耳炎	化脓性中耳炎	1
自身免疫性疾病不除外	自身免疫病	1
骨盆及C6放疗后	放射治疗	1
双膝关节髌内侧滑膜皱襞综合症	膝关节滑膜皱襞综合征	1
前庭周围神经性病变	多发性神经病[多发性神经炎/周围神经炎]	1
肝内外胆管结石伴胆管炎	胆管结石伴胆管炎	1
睡眠呼吸低通气综合征	睡眠低通气综合征	1
C6D67颌面沟窝色素沉着	色素沉着未特指的疾患	1
小腿扭伤	下肢关节和韧带扭伤	1
右肾造瘘口漏尿	肾造口状态	1
右髋关节破坏AS	强直性脊柱炎	1
右肺中叶外侧段肺组织膨胀不全	肺不张	1
左颧骨纤维异样增殖症	颧骨纤维异常增殖症	1
腹腔炎性肿块	腹腔内和盆腔的肿胀、肿物和肿块	1
脑蛛网膜炎	蛛网膜炎	1
左小腿截肢残端肌肉及皮肤软组织坏死	截肢	1
胃体Dieulafoy病	胃粘膜下恒径动脉破裂出血	1
股外侧皮神经病	身体未特指部位的神经损伤	1
左肺曲霉球病	肺曲霉菌病	1
右小腿截肢肢麻痹证气滞血瘀	截肢	1
多发颅内动脉狭窄伴不稳定斑块	动脉狭窄	1
糖尿病合并血糖过低	糖尿病性低血糖症	1
肝脏心脏重度铁沉积	铁色素沉着	1
周围性眩晕	其他周围性眩晕	1
孕1产0宫内妊娠37周单活胎LOA	孕37周	1
PSVT	阵发性室上性心动过速	1
C1-C2水平脊髓内异常病变脱髓鞘可能	脱髓鞘性脊髓病	1
陈旧性心梗后再梗左心室下壁心梗	急性再发心肌梗死	1
左肘关节尺侧副韧带肱骨髁止点撕脱性骨折	肱骨骨折	1
传染性单核细胞增多症	未特指的传染性单核细胞增多症	1
双侧输尿管软镜钬激光碎石术	输尿管结石	1
恶性胸水增大	恶性胸腔积液	1
多发性跖疣	掌跖疣	1
右肺错构瘤可能性大	肺错构瘤	1
上颌窦粘膜下囊肿	上颌窦囊肿	1
肩部色素斑	色素沉着未特指的疾患	1
急性移植物抗宿主反应病胃肠道	急性移植物抗宿主病	1
高位颈髓异常血管病变	血管性脊髓病	1
脾血管扩张充血符合淤血性脾肿大	脾大	1
甲亢性周期性麻痹	甲状腺功能亢进症合并周期性麻痹	1
肢体麻木原因待查1脑血管疾病2颈腰椎病	腰椎病	1
溃疡型腺癌	腺癌	1
双眼高度近视性黄斑病变	变性性近视[病理性近视][高度近视]	1
先天性阴囊重度畸形	睾丸和阴囊的其他先天性畸形	1
单干基底动脉先天血管变异改变	基底动脉畸形	1
中枢性损害提示脑干水平改变	脑干损伤	1
胎儿双足内翻	先天性内翻足	1
右侧4-7肋骨骨折	肋骨多发性骨折	1
左肺斑片影右肺磨玻璃影性质待定	肺部阴影	1
外周T细胞淋巴肿瘤	外周T细胞淋巴瘤(非特指型)	1
更年期掌跖角皮病	角化病	1
手臂划伤要求注射TAT	上肢开放性损伤	1
PTCA+冠脉内支架植入术后	冠状动脉支架植入术后状态	1
L5-S1区异常高密度影性质待查	其他特指身体结构诊断性影像检查的异常所见	1
血管斑痣	血管痣	1
胎盘绒毛充血局部血肿形成	未特指的胎盘疾患	1
子宫内节育器移位(下移)	避孕环移位	1
12牙根发育不全	牙根发育不良	1
右侧面横裂巨口症	颅面裂	1
颈部淋巴瘤	颈淋巴结肿大	1
双侧肾盂结石	肾结石	1
右股骨外侧骨挫伤	股骨骨折	1
牙挫伤	牙及相关组织损伤	1
血小板减少性紫癜	特发性血小板减少性紫癜	1
停经293周B超提示胎儿鼻骨显示不清	妊娠状态	1
继发性肾病综合症	肾病综合征	1
左侧眼眶外伤	眼和眶未特指的损伤	1
异位甲状旁腺	甲状旁腺异位	1
周围性神经病	多发性神经病[多发性神经炎/周围神经炎]	1
左卵巢纤维瘤	纤维瘤	1
腰4/5椎间盘突出症	腰椎间盘突出	1
癫痫(症状性)	症状性癫痫[继发性癫痫]	1
听力异常	听功能障碍	1
右上肺符合真菌诊断倾向曲霉菌	肺曲霉菌病	1
前臂肌肉扭伤	身体未特指部位的脱位、扭伤和劳损	1
周围神经炎	多发性神经病[多发性神经炎/周围神经炎]	1
肝左叶病灶介入治疗后肝右叶病灶射频治疗后	射频消融术后	1
发育不良待查	先天性发育异常	1
颈部多间隙感染	感染	1
功能性肠紊乱	肠功能紊乱	1
喉部恶性芽肿	坏疽性肉芽肿	1
左乳多发性导管扩张及大汗腺化生	乳腺导管扩张症	1
左膝半月板退变右踝关节退变	踝骨关节病	1
肾病(轻链沉积)	轻链肾病	1
药疹大疱性表皮坏死松解症	莱尔综合征[lyell综合征]	1
宫内物符合胎盘组织残留	胎盘部分残留不伴出血	1
双膝软骨退变	双侧膝关节骨性关节病	1
粘膜下平滑肌瘤	平滑肌瘤	1
右手食指近节指间关节囊破裂伴脱位	指间关节脱位	1
椎动脉供血不足	椎-基底动脉供血不全	1
继发性不孕子宫输卵管碘油造影预防抗炎	继发不孕	1
弥漫性大B细胞癌	弥漫大B细胞淋巴瘤	1
慢性咳嗽痰热咳喘音哑	慢性咳嗽	1
左上颌根尖炎性病变	根尖周炎	1
带状疱疹后综合征	带状疱疹	1
停经26周外院彩超胎儿心脏继发隔显示欠清	孕26周	1
膝关节感染	感染	1
左侧距骨副骨或撕脱性骨折可能	距骨骨折	1
符合海马硬化改变	海马硬化[颞叶内侧硬化]	1
慢性移植物抗宿主反应病皮肤肝脏骨骼关节	慢性移植物抗宿主病	1
内风湿周围神经病变	多发性神经病[多发性神经炎/周围神经炎]	1
肠套叠回肠-升结肠套叠	肠套叠	1
无力待查双下肢血管斑块	乏力	1
宫颈低级别病变CINII级	宫颈上皮瘤样病变[CIN]II级	1
疖肿病(臀部)	疖肿病	1
泌尿道梗阻(待查)	尿路梗阻	1
黄斑裂孔术后	黄斑裂孔	1
右侧眼睑皮样瘤	眼睑良性肿瘤	1
脑底异常血管网病云雾病	烟雾病[脑底异常血管网病]	1
颌下结节	面部占位	1
恶性肿瘤静脉输注化疗药物	化学治疗	1
胃病变粘膜下剥离术ESD	胃和十二指肠未特指的疾病	1
人工心脏瓣膜移植状态	具有其他心脏瓣膜置换	1
肾错构瘤破裂出血	肾错构瘤破裂出血	1
急性髓系白血病M6	急性红白血病(M6型)	1
双侧大脑半球继发恶性肿瘤	脑继发恶性肿瘤	1
骶尾部囊肿	骨盆部囊肿	1
膝关节滑膜皱襞	膝关节滑膜皱襞综合征	1
宫颈上皮内瘤变III	子宫颈上皮内瘤变III级[CINIII级]	1
顺产后宫内组织残留	胎盘部分残留不伴出血	1
腰5椎体横突撕脱性骨折	腰椎骨折L5	1
内耳耳石症	良性阵发性位置性眩晕	1
未分化多形性肉瘤	肉瘤	1
右肺中叶肺不张	肺不张	1
多脏器功能不全累及心肌肝脏凝血	多脏器功能障碍综合征[MODS]	1
宫腔异常回声待查节育环下移	避孕环移位	1
精神运动发育迟缓代谢病	发育迟滞	1
足背动脉闭塞	足部动脉闭塞	1
心c肌桥累及前降支	冠状动脉肌桥	1
胎儿异常双胎之一右锁骨下动脉迷走可能	迷走锁骨下动脉畸形	1
下肢动静脉畸形	先天性动静脉畸形	1
月经先后无定期病	月经紊乱	1
新生儿狼疮综合症	新生儿狼疮综合征	1
右侧输尿管上段结石并右肾重度积水	肾积水伴输尿管结石	1
糖尿病性胃肠植物神经病变	糖尿病性自主神经病	1
双侧颈动脉粥样硬化伴斑块形成	颈动脉粥样硬化	1
右臀肌扭伤	身体未特指部位的脱位、扭伤和劳损	1
2型糖尿病并心脏损害	2型糖尿病	1
右腰背部肉芽肿性炎	肉芽肿	1
左下肢周围神经病变	多发性神经病[多发性神经炎/周围神经炎]	1
高血压病肾病	高血压性肾病	1
穿刺活检，右肺占位，预防出血	肺占位性病变	1
停经245周B超提示胎儿上腔静脉走形迂曲	妊娠状态	1
从2米高房屋上摔下致伤	自高处坠落	1
双眼眼袋	下睑袋	1
放疗完成	放射治疗	1
颅面骨发育不全	颅面骨发育不全	1
子宫发育不全	子宫发育不全	1
颈胸背部广泛皮下气肿并纵膈积气	纵隔气肿	1
急性移植物抗宿主反应病IV度肝脏肠道	急性移植物抗宿主病	1
右眼皮肤擦伤	眼睑和眼周区其他浅表损伤	1
左侧脑室脑膜瘤，WHO I级，皮细胞型。	脑室脑膜瘤	1
髓核组织伴部分坏死及钙盐沉积	钙质沉着症	1
完全流产	流产,完全性或未特指,无并发症	1
胰头肿物	胰腺肿物	1
慢性心功能衰竭急性发作全心增大	慢性心力衰竭	1
右侧胫骨上端骨折	胫骨上端骨折	1
足趾关节肿痛	关节痛	1
上感（胃肠型 ）	胃肠型感冒	1
动脉粥样硬化斑块形成狭窄	动脉粥样硬化	1
肉芽肿性小叶炎	乳腺炎性肉芽肿	1
L2右侧横突锥弓及棘突根部骨质破坏	骨质破坏	1
左拇指指腹皮肤缺失	皮肤缺损	1
血液粘滞	高粘滞综合征	1
右半结肠Crohn氏病	结肠克罗恩病	1
1新生儿胎粪综合征	新生儿胎粪吸入综合征	1
右肾小错构瘤	肾错构瘤	1
右膝部软组织损伤	下肢未特指的损伤,水平未特指	1
男性生殖器官特指疾病	男性生殖器官其他特指的疾患	1
妊娠39+3周，胎儿宫内窘迫？	孕39周	1
自身免疫性疾病未分型	自身免疫病	1
大便次数减少直肠局部隆起	大便习惯改变	1
右乳错构瘤	乳房错构瘤	1
左支气管支架置入术3	气管支架置入术后	1
老年斑	脂溢性角化症	1
颅底凹陷继发性颈髓病变	脊髓病	1
停经355周院外B超提示胎儿胃泡增大	妊娠状态	1
颈背部肌纤维组织炎	肌纤维炎	1
右颞顶骨大面积粉凹陷性碎性骨折	颅骨骨折	1
糖尿病性周围神经病变可能	糖尿病性周围神经病	1
高血压Ⅰ期	高血压	1
舌骨后占位	口腔和咽喉部占位	1
脑血流减慢T波改变	心电图异常	1
左侧腹直肌拉伤	腹部、下背和骨盆肌肉和肌腱损伤	1
右肱骨大转子撕脱性骨折	肱骨骨折	1
完全性肺静脉异位引流心下型无梗阻	完全性肺静脉异位引流,心下型	1
皮肤湿疹性癌变	湿疹样癌[佩吉特病][Paget病]	1
左侧软腭裂伤	软腭开放性损伤	1
皮肤炎性周围神经病	多发性神经病[多发性神经炎/周围神经炎]	1
右肺尖陈旧性病变左肺下叶纤维增殖灶	肺病	1
左膝关节运动性劳损	膝的其他和未特指部位的扭伤和劳损	1
第五第六脑室形成发育变异	先天性第五六脑室	1
脑脊液异常所见表皮葡萄球菌	葡萄球菌感染	1
左腓骨骨缺损骨不连	腓骨骨折不连接	1
口腔异味	口臭	1
慢性心功能不全心功能III级	心功能III级(NYHA分级)	1
胸腹主动脉动脉瘤	胸腹主动脉瘤	1
腰椎间隙感染	感染	1
贲门胃体病变内镜粘膜下剥离术	胃和十二指肠未特指的疾病	1
阿尔茨海默病重度痴呆	阿尔茨海默病性痴呆	1
十二指肠球部狭窄2次球囊扩张术	十二指肠狭窄	1
左侧肢体活动不灵伴意识不清原因待查	意识障碍	1
逸搏心律	心律失常	1
右附件区囊性回声输卵管积液待排	输卵管积水	1
右锁骨考虑Sweet病	急性发热性嗜中性皮病	1
泌乳综合征[福－奥二氏综合征]	停经泌乳综合征	1
急性缺血性脑病	脑血管供血不足	1
左上肺放射性肺纤维化干细胞治疗后	肺纤维化	1
肝脏细胞轻度脂肪变性	脂肪肝	1
苍白球钙化	脑钙化	1
视网膜修复术后	眼术后	1
左侧少量胸水考虑结核性	结核性胸腔积液	1
CAVC左室发育小	完全型心内膜垫缺损	1
主动脉缩窄	主动脉缩窄	1
停经351周B超提示胎儿心脏结构异常	妊娠状态	1
滴虫炎	未特指的滴虫病	1
扁桃体炎抵抗力低下	扁桃体炎	1
妊1产0妊286周臀头位	妊娠状态	1
退变的纤维软骨	软骨疾患	1
多发性大肠息肉	大肠息肉	1
乳腺纤维囊性乳腺病	乳腺囊性增生病	1
COPD稳定期	慢性阻塞性肺疾病	1
中毒性多发性周围神经病	多发性神经病[多发性神经炎/周围神经炎]	1
2左额颞顶部颅骨缺损右颞右枕骨折	颅骨骨折	1
亚急性淋巴结炎	淋巴结炎	1
左颈总动脉发育异常	颈内动脉畸形	1
急性IV度GVHD累及肠道皮肤肝脏	急性移植物抗宿主病	1
右侧颈内动脉C1段动脉瘤	颈内动脉瘤	1
骶尾椎病变马尾神经受压	脊髓受压	1
右手第三掌骨脱位第二掌骨小多角骨脱位	掌指关节脱位	1
脑底血管异常网病	烟雾病[脑底异常血管网病]	1
左手第1掌骨部分骨质缺损并腕掌关节半脱位	腕掌关节脱位	1
心肌酶升高	心肌酶谱异常	1
家族性遗传性慢性天疱疮	良性慢性家族性天疱疮	1
阴道前壁中度膨出后壁轻度膨出	阴道前后壁脱垂	1
月经不调黄体功能不良	月经紊乱	1
上肢动静脉瘘	动静脉瘘	1
宫颈鳞状上皮内高度病变CIN-Ⅲ累及腺体	子宫颈上皮内瘤变III级[CINIII级]	1
面肿湿阻血瘀月经不调淋漓	月经紊乱	1
脐茸	脐茸	1
周围神经病变保守治疗后	多发性神经病[多发性神经炎/周围神经炎]	1
颊粘膜裂伤	口腔粘膜开放性损伤	1
章鱼罐综合症	应激性心肌病[心尖球形综合征]	1
1软骨恶性肿瘤23	未特指的四肢骨和关节软骨恶性肿瘤	1
双上眼睑血管瘤	血管瘤	1
停经266周B超提示胎儿双侧外耳外观异常	妊娠状态	1
坐骨神经麻痹	坐骨神经损害	1
双肺肺大疱	肺大疱	1
化脓性毛囊周围炎	脓肿性穿掘性头部毛囊周围炎	1
胎儿肺动脉吊带可能胎儿肾盂分离	肺动脉吊带[先天性迷走左肺动脉]	1
右肱骨放疗中	放射治疗	1
颞叶内侧脑组织局部胶质细胞轻度增生	脑胶质细胞增生	1
右肺下叶错构瘤	肺错构瘤	1
血液化学特指异常所见TPSA升高	肿瘤标记物升高	1
左足拇指远节趾骨基底部撕脱性骨折	拇趾骨折	1
颈56椎体左侧异常信号影	其他特指身体结构诊断性影像检查的异常所见	1
高LGE综合征	高IgE综合征	1
髓性脂肪瘤	骨髓脂肪瘤	1
乳腺多处恶性肿瘤	乳腺恶性肿瘤	1
Ⅳ期褥疮	受压区Ⅳ期褥疮	1
胎儿超声异常永久性右脐	永久性右脐静脉	1
颌面部感染	感染	1
乙状结肠单腔造瘘术后	结肠造口状态	1
左大腿皮下大粉瘤	皮脂腺囊肿	1
跟腱骨化	关节周围骨化	1
停经28周B超提示胎儿双侧肾盂分离	孕28周	1
不完全阴道纵隔	阴道纵隔	1
肝硬化食管胃底静脉曲张破裂出血	肝硬化伴食管静脉曲张破裂出血	1
自身免疫性脊髓病	脊髓病	1
双腿僵手麻浮肿	局部水肿	1
化扁大肺	急性化脓性扁桃体炎	1
停经34周MR提示胎儿骶尾椎排列紊乱	孕34周	1
左眼老年性湿性黄斑病变	老年性黄斑变性	1
下颌瞬目综合征左	下颌瞬目综合征[MarcusGunn综合征]	1
胃肠功能紊乱，疝气	胃肠功能紊乱	1
右上肢猫抓伤口腔动物致伤	上肢损伤	1
左颈内动脉起始段内膜病变伴局限狭窄	颈内动脉狭窄	1
腕关节骨性关节炎(单侧严重性)	腕骨关节病	1
左锁骨下动脉及左椎动脉支架置入术	血管支架植入术后状态	1
血脂高	高脂血症	1
左侧髂窝囊性占位	骨盆部囊肿	1
右膝外侧半月板体部Ⅲ°放射裂后角Ⅲ°水	膝外侧半月板撕裂	1
睡眠呼吸暂停综合征	睡眠呼吸暂停低通气综合征	1
右侧髂血管旁淋巴结肿大	淋巴结肿大	1
语言功能障碍	言语和语言发育障碍	1
高乳素血症	高泌乳素血症	1
溶血性尿毒综合症不除外	溶血-尿毒综合征	1
右胫骨下段慢性骨髓炎	胫骨骨髓炎	1
肾移植后排异反应	肾移植排斥	1
突发特发性听觉减退左耳	突发性聋	1
颅内颈髓多发脱髓鞘改变	脱髓鞘病	1
1左肱骨头坏死伴缺损2左肩关节继发性	肱骨头缺血性坏死	1
热水烫伤躯干右股TBSA7%深Ⅱ度	下肢烫伤	1
胃疼病全麻胃肠镜检查丙泊酚不耐受	胃痛	1
右手指麻木待查腕管综合症	腕管综合征	1
高血压、LAD-AO瘘	高血压	1
左前胸壁包块:囊肿	胸部囊肿	1
高血压特病	高血压	1
右侧豌豆骨不全性骨折	豆骨骨折	1
双肺广泛斑片影伴间质改变	肺部阴影	1
淋巴瘤白血病T细胞型	T淋巴母细胞白血病/淋巴瘤	1
创伤性胰腺断裂	胰腺破裂	1
右足针刺感腰椎间盘病变	椎间盘疾患	1
腋窝皮脂腺囊肿	皮脂腺囊肿	1
高血压病病	高血压	1
妊娠性心脏改变	循环系统疾病并发于妊娠、分娩和产褥期	1
外阴交搭跨越恶性肿瘤	外阴交搭跨越恶性肿瘤的损害	1
特发性色素性斑	色素沉着未特指的疾患	1
眼植入物移位	其他眼假体装置、植入物和移植物的机械性并发症	1
脓毒症性脑病	脓毒症	1
皮肤软组织撕脱并缺损	皮肤缺损	1
中毒型表皮坏死松解症	莱尔综合征[lyell综合征]	1
停经23周发现胎儿胃泡旁点状强回声	孕23周	1
右眼裂外眦外伤后疤痕粘连	外眦瘢痕	1
宫颈腺体囊性增生伴局部腺体低级别异型增生	子宫内膜囊性增生	1
纵膈腹主动脉旁腹膜后腹腔淋巴结化疗后	化学治疗	1
左眼视网膜全部脱落右眼部分脱离	视网膜脱离	1
主动脉增宽伴轻度反流	主动脉瓣关闭不全	1
胸壁皮肤受侵	胸壁继发恶性肿瘤	1
左上肢浮肿静脉血流瘀滞可能性大	水肿	1
新生儿先天性心血管畸形	先天性心脏病	1
腰椎间盘腰45椎腰5骶1椎突出继发椎	腰椎间盘突出	1
胆道高位梗阻考虑恶性	胆道恶性肿瘤	1
双侧股骨头置换术后	人工关节术后	1
先天性骨骼发育异常	骨骼发育不良	1
骨穿支持免疫相关性血细胞减少	免疫相关性血细胞减少症（IRP）	1
慢性肾衰竭CKD	慢性肾衰竭	1
右侧第45前肋及第6后肋骨质破坏性质待查	骨质破坏	1
停经31周B超提示胎儿卵圆孔增大	孕31周	1
左踝关节及距下关节骨质破坏伴局部缺失	骨质破坏	1
G2P0孕34+5周宫内妊娠L	孕34周	1
TC静脉化疗9程	化学治疗	1
双侧枕叶散在小缺血梗塞陈旧性	陈旧性脑梗死	1
胎儿异常内脏外翻胸腹壁缺损	胎儿腹裂	1
多发颌面部骨折	面骨多发性骨折	1
趾外翻	足畸形	1
先天性大疱性表皮松解可能性大	大疱性表皮松解症	1
软骨钙沉着其他的	软骨钙质沉着病	1
乳房，未特指(C50.9)	未特指的乳房恶性肿瘤	1
喉上神经炎	单神经炎	1
眼球破裂伴有眼内组织缺失	眼球破裂伤	1
停经285周B超提示胎儿左上腹部囊性回声	妊娠状态	1
腹痛待查(左下)	下腹痛	1
胎儿骨骼发育异常	骨骼发育不良	1
口腔弥漫性扁平苔藓	扁平苔癣	1
低血糖病胰腺内分泌病	低血糖症	1
C4-6椎间盘突出	颈椎间盘突出	1
下肢动脉阻塞	下肢动脉栓塞	1
双肺间质改变双上肺多发点状影	肺部阴影	1
皮肤病其他	皮肤和皮下组织其他特指的疾患	1
右侧骶韧带妊娠	异位妊娠	1
重症2呼吸窘迫	急性呼吸窘迫综合征	1
多脏器功能不全肝肾肌酶凝血	多脏器功能障碍综合征[MODS]	1
肿瘤性马尾神经不全损伤	马尾损伤	1
右基底节梗塞灶亚急性左基底节陈旧	基底节脑梗死	1
双膝弹响	弹响膝	1
高渗性高血糖状态	血糖升高	1
新生儿缺血缺氧性脑损伤	新生儿缺氧缺血性脑病	1
ECG:窦性心律；非特异性T波异常	心电图异常	1
双眼老年性黄斑变性	老年性黄斑变性	1
腕部肌筋膜劳损	腕部劳损	1
直肠术后化疗	恶性肿瘤术后化疗	1
宫内双死胎单绒双羊	双胎死产	1
第一腰椎压缩性骨折	腰椎压缩性骨折	1
心功能Ⅰ级KILLIP	KillipI级	1
腹腔热灌注化疗后	化学治疗	1
特发性肺动脉高血压	原发性肺动脉高压	1
横行腹直肌肌皮瓣移植术后	皮瓣移植状态	1
右环指近节指骨近端内生软骨瘤	指骨近节骨折	1
64龋(牙)	龋病	1
双侧跟骨刺	跟骨骨质增生[跟骨骨刺]	1
宫颈考虑局灶腺体高级别异型增生	宫颈上皮不典型增生	1
骨髓增生明显活跃单核样细胞数量明显增多	单核细胞增多	1
双手肌萎缩	肌肉萎缩	1
空蝶鞍垂体受压改变	空泡蝶鞍综合征	1
多器官功能损伤	多脏器功能障碍综合征[MODS]	1
左手手背皮瓣臃肿	皮瓣移植状态	1
右侧乳房溢血	乳头溢液	1
胎儿染色体发育异常	先天性胎儿染色体异常	1
前交叉韧带断裂术后	膝关节前十字韧带完全断裂	1
左拇趾及左足背缺血坏死	下肢皮肤坏死	1
左睾丸回缩	回缩睾丸	1
胎儿巨膀胱后尿道闭锁不除外	先天性尿道闭锁	1
左侧气胸41双侧胸部颈部皮下气肿	气胸	1
手指脱位	指关节脱位	1
慢性胆囊结石胆囊炎	胆囊结石伴慢性胆囊炎	1
口角割伤	口腔和咽喉部损伤	1
继发干燥综合	继发性干燥综合征	1
脑病待诊	脑病[器质性脑病]	1
胃窦异位胰腺	胃内异位胰腺	1
MALT淋巴瘤	非霍奇金淋巴瘤(B细胞型)	1
无力性脚感觉异常症	不安腿综合征[不宁腿综合征]	1
食道符合Barrett食管胃体粘膜慢性	巴氏食管	1
脾脏高度充血致脾肿大	脾大	1
骶骨外伤	骶骨骨折	1
胃窦毛细血管扩张	胃肠道毛细血管扩张症	1
支气管扩张症继发感染	支气管扩张症合并感染	1
肝病脑病I期	肝性脑病	1
取出宫内节育器	取出子宫内避孕装置	1
右面部葡萄酒色斑	鲜红斑痣[葡萄酒色痣]	1
双下肢跛行待查小平足	扁平足	1
双侧背部软组织拉伤	躯干未特指的损伤,水平未特指	1
右颌下静脉畸形	血管畸形	1
慢性移植物抗宿主反应肺肝皮肤口腔	慢性移植物抗宿主病	1
肺血管性疾病	肺血管未特指的病	1
中分化腺癌	腺癌	1
胸部皮肤破裂伤	胸部开放性损伤	1
右侧移位迷走锁骨下动脉	迷走锁骨下动脉畸形	1
中指掌指关节部分脱位	掌指关节脱位	1
右膝关节面软骨损伤	膝关节损伤	1
失血性贫血	贫血	1
眼裂小待查	睑裂狭小	1
左下肢髂总静脉嵌压	髂总静脉压迫综合征[Cockett综合征]	1
交界逸搏心律	结性逸搏	1
肺心病缓解期	肺源性心脏病	1
肺部曲毒菌病	肺曲霉菌病	1
卵巢良性肿物	卵巢肿物	1
出血性血小板增多症	原发性血小板增多症	1
左下肢体无力查因	肢体无力	1
结膜炎，准分子术后ou	结膜炎	1
不慎自台阶上摔倒致伤左膝部	下肢未特指的损伤,水平未特指	1
双颈动脉粥样硬化症	颈动脉粥样硬化	1
右膝关节外翻畸形	膝外翻	1
双肺间质性改变伴轻度纤维化	肺间质纤维化	1
右拇指神经断裂	神经断裂	1
右侧恶性胸水原发病灶待查	恶性胸腔积液	1
胸椎骨质破坏待诊T10	骨质破坏	1
颌下皮肤裂伤	颞颌下区开放性损伤	1
粒细胞减少症 复诊	中性粒细胞减少症	1
骶尾部穿透伤	骨盆开放性损伤	1
6胎儿溶血	胎儿和新生儿未特指的溶血性疾病	1
新生儿小女卵圆孔未闭	卵圆孔未闭	1
轻度系膜增生样肾小球病变	系膜增殖性肾小球肾炎	1
大疱表皮松解萎缩坏死型药疹	莱尔综合征[lyell综合征]	1
盆腔三维适形放疗后复发陀螺刀治疗后	放射治疗	1
L1椎体压缩骨折	腰椎压缩性骨折	1
右肺继发恶性肿瘤	肺继发恶性肿瘤	1
乳牙外伤	牙及相关组织损伤	1
功能性胃肠紊乱	胃肠功能紊乱	1
肿标增高待查十二指肠隆起型病变	肿瘤标记物升高	1
先天性脊髓栓系综合征	脊髓栓系综合征	1
淋巴结Castelman病	Castleman病	1
右侧输尿管闭锁	先天性输尿管闭锁	1
双侧颊部扁平苔藓免疫异常	扁平苔癣	1
染色体异常口腔功能障碍	染色体病	1
S1椎体结核	脊柱结核	1
右上臂截肢后残端骨质过度生长	截肢	1
放射性粘膜损伤	放射性损害	1
符合巨幼红细胞性贫血骨髓改变	巨幼红细胞性贫血	1
妊娠合并子宫肌瘤红色变性	妊娠合并子宫肌瘤	1
左拇趾指甲撕脱	甲脱离	1
胰尾部恶性病变	胰尾恶性肿瘤	1
MODS呼吸循环肾肝脑凝血免疫	多脏器功能障碍综合征[MODS]	1
结肠脾曲高代谢恶性待排	结肠恶性肿瘤	1
十二指肠降段隆起性病变	胃和十二指肠未特指的疾病	1
停经312周B超提示胎儿双侧肾窦分离轻度	妊娠状态	1
糖尿病性神经病变足病	糖尿病足	1
右扁桃体隐窝赘生物	扁桃体息肉	1
肾脏综合征	肾病综合征	1
右踝距骨舟骨跖骨异常型号骨梗死可能	骨坏死	1
颈椎间盘脱出	颈椎间盘突出	1
糖尿病反复低血糖严重并发症	糖尿病性低血糖症	1
右侧大量胸腔积液	胸腔积液	1
青年期心律失常	心律失常	1
左眼皮肤擦伤	眼睑和眼周区其他浅表损伤	1
大汗腺炎	未特指的顶(浆分)泌汗腺疾患	1
多发淋巴结转移	多部位淋巴结继发恶性肿瘤	1
糖尿病并血管病変	糖尿病	1
室性逸搏	室性逸搏性心律	1
大肠埃希杆菌感染	大肠杆菌感染	1
L32腰椎体终板炎L	骨软骨炎	1
左肺下叶支气管扩张症	支气管扩张症	1
预防措施其他特指的放疗脑	放射治疗	1
C2-3棘突融合	脊柱的其他融合	1
NKT细胞淋巴瘤	结外NK/T细胞淋巴瘤(鼻型)	1
不全行子宫纵隔	子宫纵隔	1
右室双出口	右心室双出口	1
胸片提示：右上肺可疑结节	肺占位性病变	1
先天性面部不对称待查	先天性发育异常	1
右髋臼及腰椎下段骨破坏	骨质破坏	1
心肌扩张	扩张性心肌病[充血性心肌病]	1
妊1产0妊372周臀头位	妊娠状态	1
左侧肢体周围神经病变	多发性神经病[多发性神经炎/周围神经炎]	1
胎儿异常胎儿融合肾	融合肾	1
颈3-6椎间盘突出	颈椎间盘突出	1
肝功能心功能受损外伤性	肝功能异常	1
双下肢动脉硬化伴散在斑块	肢体动脉硬化	1
慢性弥漫性肝疾患	未特指的肝病	1
右眉缺失上睑闭合不全	眼睑闭合不全[兔眼]	1
女性不育症与宫角阻塞有关	子宫起因的女性不孕症	1
RHCC晚期	肝细胞癌	1
内侧副韧带股骨止点撕脱性骨折	股骨骨折	1
腰1椎体爆裂骨折	腰椎骨折L1	1
急性移植物抗宿主反应病皮肤胃肠道	急性移植物抗宿主病	1
双肺多发斑片及磨玻璃影	肺部阴影	1
左肘关节功能障碍左膝髌骨骨梗死	骨坏死	1
右侧乳腺错构瘤	乳房错构瘤	1
胃肠动力低下	胃肠功能紊乱	1
慢性炎症性脱髓鞘性多发性神经病	慢性炎性脱鞘性多发性神经根神经病[慢性吉兰-巴雷巴利综合征]	1
内分泌性突眼良性突眼可能性大	眼球突出	1
牙龈感染	感染	1
非霍奇金淋巴瘤 滤泡性	未特指的滤泡性非霍奇金淋巴瘤	1
双眼角结膜炎	结膜炎	1
脑血管病变复查脑血流图检查	脑血管病	1
肌弛缓先天性奥本海姆氏病	先天性肌弛缓综合征[松软儿]	1
脊髓灰质炎治疗后	急性脊髓灰质炎	1
肠系膜血管炎	血管炎[脉管炎]	1
慢性非特异性溃疡性结肠炎	溃疡性结肠炎	1
小样儿(足月)	足月小样儿	1
颅内血管狭窄左中重度狭窄右中中度狭窄	动脉狭窄	1
右侧冈上肩胛下肌腱退变部分撕裂	肩胛下肌肌腱损伤	1
脊柱隐裂	先天性隐性脊柱裂	1
脐周间断性隐痛待查	腹痛	1
心功能II级(KILLIP分级)	KillipII级	1
双眼局限性脉络膜视网膜色素上皮病变	分类于他处的疾病引起的其他脉络膜视网膜疾患	1
停经314周B超提示胎儿胎盘异常回声	妊娠状态	1
垂体Rathke裂隙	先天性垂体发育异常	1
流产后延迟出血	流产后出血	1
下肢曲张静脉剥离术	下肢静脉曲张	1
滤泡癌	滤泡性癌	1
右颈内静脉长期血透导管半脱出	透析导管引起的机械性并发症	1
右侧股骨头坏死	股骨头缺血性坏死	1
多发性骨髓瘤IgA型III期B组化疗后	多发性骨髓瘤	1
右手皮脂腺囊肿	皮脂腺囊肿	1
腹部手术后乏力	乏力	1
泌尿结石，软组织伤	泌尿系结石	1
右踝肿块	下肢肿物	1
新生儿卵圆孔未闭20mm转归其他	卵圆孔未闭	1
肺错构瘤	肺错构瘤	1
双膝髌骨局灶性骨梗死骨代谢异常	骨坏死	1
胰腺体部脂肪浸润或小囊肿可能	胰腺囊肿	1
右肺少许增生的梭行细胞伴异性考虑恶性	右肺恶性肿瘤	1
节育环膀胱异位	避孕环移位	1
头痛;急性胃黏膜病变	头痛	1
双侧股骨发育畸形	先天性股骨发育不良	1
侵犯胸壁2周期化疗后	化学治疗	1
双下肢胀痛	下肢疼痛	1
左侧口底粘膜下血肿机化	血肿机化	1
阻塞性肺疾病伴限制性通气倾向	慢性阻塞性肺疾病	1
左颊部涎腺粘液囊肿	唾液腺粘液囊肿	1
急性移植物抗宿主反应肝脏I度	急性移植物抗宿主病	1
左侧颈部淋巴组织增生性病	淋巴组织增生病	1
母体前置胎盘新生儿	胎儿和新生儿受前置胎盘的影响	1
左肾高密度影结合临床除外高密度囊肿	泌尿器官诊断性影像检查的异常所见	1
WERNICKE脑病	韦尼克失语症[Wernicke失语症]	1
阵发性夜间呼吸困难综合征	阵发性夜间呼吸困难	1
骨髓增生异常骨髓增殖性肿瘤	骨髓增生异常性/骨髓增殖性肿瘤(不能分型)	1
腰1椎体压缩性骨折	腰椎压缩性骨折	1
骶尾部纤维脂肪组织化脓	软组织感染	1
右侧胫骨骨缺损及骨不连	胫骨骨折不连接	1
顺产后4天胎盘残留	胎盘部分残留不伴出血	1
周围神经病(多发性)	多发性神经病[多发性神经炎/周围神经炎]	1
腰4、5椎体不稳	腰椎不稳定	1
糖尿病性胃肠神经病变	未特指的糖尿病伴有神经的并发症	1
阵发性心房颤动心房纤颤	阵发性心房颤动	1
右腿撞伤	下肢未特指的损伤,水平未特指	1
右侧坐骨囊肿	骨盆部囊肿	1
高血压病(左室舒张功能减退)	高血压	1
毛囊红斑黑变病	面颈部毛囊性红斑黑变病	1
20晚孕单活胎胎儿左心室强光点	妊娠状态	1
悬雍垂先天性分裂	悬雍垂裂	1
左眼ICE综合症	虹膜角膜内皮综合征[ICE综合征]	1
停经283周B超提示胎儿右侧腹部无回声区	妊娠状态	1
带状疱疹性神经痛	带状疱疹后神经痛	1
右小腿截肢术后骨外露并感染	截肢	1
急性肠道移植抗宿主病I度	急性移植物抗宿主病	1
热液烫伤25%面部躯干左上肢双下肢	多发烫伤	1
急性喉炎-支炎	急性喉气管炎	1
左颌颈部肉芽肿性炎	肉芽肿	1
左股动脉支架植入术	周围血管支架植入术后状态	1
1型糖尿病性植物神经病	1型糖尿病性自主神经病	1
新生儿脓疮病	新生儿脓胞疮[新生儿脓疱病]	1
新生儿右足外翻畸形	先天性足畸形	1
病毒性淋巴结炎	淋巴结炎	1
头胀待查TIA	短暂性脑缺血发作	1
双跟骨骨折	跟骨骨折	1
弥漫性肺纤维化	肺纤维化	1
左手中指撕脱性骨折	指骨骨折	1
右胫骨下段骨折24天	胫骨骨折	1
继发性血红蛋白增多症	血红蛋白增高	1
镜面右位心	镜面右位心	1
颅内病变X刀治疗后	放射治疗	1
急性布-加综合征肝静脉型	布-加综合征[budd-chiari综合征]	1
右肺淋巴结增生性病变	淋巴组织增生	1
抗病毒治疗高指血症	高脂血症	1
右乳纤维上皮性肿瘤	纤维上皮瘤	1
非霍奇金B细胞淋巴瘤	非霍奇金淋巴瘤(B细胞型)	1
经典型霍奇金结节硬化型	结节硬化型经典霍奇金淋巴瘤	1
右手腕针刺伤	腕和手未特指的损伤	1
肺气肿并肺大泡形成	大疱性肺气肿	1
加速性性交界性逸搏心律	结性逸搏	1
癫痫。运动发育落后	癫痫	1
右小趾甲畸形	未特指的甲疾患	1
双下肺肺炎	肺炎	1
右肩脱位	肩关节脱位[盂肱关节脱位]	1
绝经后子宫	绝经期	1
幼儿急疹[第六病]	幼儿急疹	1
意识不清待诊	意识障碍	1
左口角粘膜包块	口腔肿物	1
脑梗死多发颅内血管狭窄	脑梗死	1
右示指皮肤缺失皮肤软组织缺失	皮肤缺损	1
左室向心性肥厚左室舒张功能减低	心室肥厚	1
右肺下叶GGO	肺部阴影	1
剖宫产术后宫内早孕	剖宫产史的妊娠	1
慢性风湿性心脏病	风湿性心脏病	1
肌酶增高查因肌酶增高查因肌酶增高查因	肌酸激酶增高	1
停经32周B超提示胎儿左侧脑室正常高值	妊娠状态	1
甲亢合并妊娠	妊娠合并甲状腺功能亢进	1
踝关节创伤性关节病变	踝关节损伤	1
口周麻木	口周皮肤麻木	1
顽固性座疮心脾气阴两虚	痤疮	1
血管结构畸	血管畸形	1
全心功能减弱	全心衰竭	1
左输尿管双J管嵌顿	输尿管支架置入术后	1
宫颈节育器移位	避孕环移位	1
假性甲状旁腺减退症	假性甲状旁腺功能减退	1
胼胝体及双侧侧脑室后角异常信号影	颅骨和头诊断性影像检查的异常所见,不可归类在他处者	1
右跟腓韧带止点撕脱性骨折	跟骨骨折	1
右枕叶血管畸形	头部血管畸形	1
先天性肠重复畸形	肠重复畸形	1
口咽干燥	口干	1
慢性移植物抗宿主反应病口腔关节皮肤	慢性移植物抗宿主病	1
下颌骨颏部及双侧髁突骨折	下颌骨骨折	1
亚急性闭合性脑外伤1右侧额顶部硬膜外血肿	创伤性硬脑膜外血肿	1
黑毛痣	色素痣	1
左腕关综合症	腕管综合征	1
全身骨关节先天发育不良	骨骼发育不良	1
慢性阻塞性肺疾病急性期	慢性阻塞性肺疾病	1
大便习惯性质改变待查肠镜检查	大便习惯改变	1
点状角膜炎	浅层点状角膜炎	1
颈部木棍刺伤并存留	颈部开放性损伤	1
溶血状态遗传性球形细胞增多症可能性大	遗传性球形红细胞增多症	1
回盲部黄色肉芽肿性炎	黄肉芽肿	1
多动症？	注意缺陷与多动障碍	1
肛管末端代谢局灶性增高考虑为痔疮可能性大	痔	1
腹股沟部挫伤	腹股沟区挫伤	1
特指垂体疾患Rathke裂隙	其他垂体疾患	1
T-幼淋细胞白血病	T细胞型幼淋巴细胞白血病	1
肝内胆管囊样扩张症Caroli病	先天性肝内胆管囊状扩张症[Caroli病]	1
乙状结肠术后化疗	恶性肿瘤术后化疗	1
右坐骨异常信号囊肿可能	骨囊肿	1
双肾囊肿多发	肾囊肿	1
左足皮瓣臃肿术中诊断左足皮瓣臃肿	皮瓣移植状态	1
1021咽拭子病毒筛查示EV71病毒阳性	手足口病	1
中度听力损害	听功能障碍	1
剑突下疼痛待查;心肌梗死;	剑突下疼痛	1
宫颈CINI后穹窿微浸润	子宫颈上皮瘤样病变[CIN]I级	1
右肾包膜下血肿	肾血肿	1
阴茎侧弯	阴茎屈曲畸形	1
肝交界恶性肿瘤	肝恶性肿瘤	1
右肺下叶肺占位性病变	肺占位性病变	1
慢性炎症性脱髓鞘性多神经根神经病	脱髓鞘病	1
脾肾不足疖肿肾气不足	皮肤疖肿	1
表皮下水疱	身体浅表水疱	1
左小腿中下段左足跟后侧软组织缺损伴坏死	足坏死	1
低分化腺鳞癌	鳞状细胞癌	1
停经152周B超提示胎儿巨大膀胱	妊娠状态	1
右食指近指间关节囊破裂伴部分骨质缺损	手指损伤	1
精神发育不良	精神发育迟滞	1
胰后脾静脉海绵样变	海绵状血管瘤	1
继发性抗磷酯综合征	抗磷脂综合征	1
双眼老年性黄斑病变右眼陈旧性	老年性黄斑变性	1
神经鞘膜瘤	神经鞘瘤	1
低级别滤泡性淋巴瘤IV期B组	滤泡淋巴瘤	1
腹白线疝 腹腔镜术后	腹白线疝	1
小儿唐氏综合征	21-三体综合征[Down综合征]	1
双侧颈动脉多发粥样硬斑形成	颈动脉粥样硬化	1
经前紧张综合征	经前期紧张综合征	1
非酒精性脂肪肝病	脂肪肝	1
造瘘口肠粘膜脱出	胃肠道的其他人工造口状态	1
鼻骨多发骨折	鼻骨骨折	1
夜尿多待查	尿频	1
B细胞淋巴瘤倾向粘膜相关淋巴瘤	粘膜相关淋巴组织结外边缘区B细胞淋巴瘤	1
神经精神发育延迟	发育迟滞	1
右胫骨中下端骨折畸形愈合	胫骨干骨折	1
左肺部块状影及积液性质待查	肺部阴影	1
胃底-贲门浸润性病变恶性病变未排除	胃底及贲门恶性肿瘤	1
双下肢大隐静脉曲张术后复发	大隐静脉曲张	1
子宫妊娠	妊娠状态	1
mp感染	支原体性肺炎	1
双下肢粥样硬型闭塞症	下肢动脉粥样硬化闭塞症	1
产伤性Ⅰ度会阴裂伤	分娩伴会阴裂伤I度	1
膀胱新生物	膀胱息肉	1
合并骶丛部分性根性损害	腰骶丛损害	1
汗证厌食花剥舌夜惊配药	睡惊症[夜惊症]	1
宫颈病变环切术后	宫颈术后	1
右上睑睑缘炎	睑缘炎	1
网膜转移	转移性肿瘤	1
肝右后叶挫伤	肝挫伤	1
自身免疫性溶血性疾病(冷型)	自身免疫性溶血性贫血(冷型)	1
先天性肾血管畸形	肾血管畸形	1
截断术残端特指的并发症	再植和截断术所特有的并发症	1
上腹隐痛	上腹痛	1
三尖瓣疾病	未特指的三尖瓣疾病	1
腕和手水平肌肉和肌腱损伤	在腕和手水平的未特指肌肉和肌腱的损伤	1
右前臂皮下血肿伴机化	血肿机化	1
脊髓栓系综合症术后	脊髓栓系综合征	1
单个手指离断	其他单个手指创伤性切断(完全)(部分)	1
错构瘤	错构瘤	1
右胫腓骨远端骨质破坏	骨质破坏	1
L1腰椎压缩性骨折	腰椎压缩性骨折	1
右顶颅骨膜血窦	颅骨膜窦	1
骶尾骨痛	尾骨痛	1
左膝关节浅表肿物	膝关节肿物	1
急性脑梗死右侧额叶皮层下小梗死	脑梗死	1
发育不全	先天性发育异常	1
带状疱疹性耳炎	带状疱疹伴有其他并发症	1
脂肪脊髓脊膜膨出	脊髓脊膜膨出	1
LOA剖一男活婴持续性枕横位	经未特指的剖宫产术分娩	1
其他d左前额裂伤d	前额开放性损伤	1
胆囊胆固醇样息肉	胆囊息肉	1
右内踝及距骨内侧骨软骨缺损伴游离体形成	踝关节内游离体	1
1.不全流产	未特指的流产,不完全性,无并发症	1
主动脉弓粥样斑块形成并管腔轻度狭窄	主动脉弓狭窄	1
右第一足趾创伤性足趾切断	单趾切断	1
分娩伴会阴裂伤Ⅰ度	分娩伴会阴裂伤	1
双髋退变	双侧髋关节骨性关节病	1
双乳分叶状肿瘤	叶状瘤	1
腰椎管占位	椎管内占位性病变	1
右腘窝软组织伤	下肢未特指的损伤,水平未特指	1
颊部血管瘤	面部血管瘤	1
Alzheimer病混合型	阿尔茨海默病(混合型)	1
左喉部占位	口腔和咽喉部占位	1
大疱性表皮松解萎缩坏死型药疹	莱尔综合征[lyell综合征]	1
雷诺病	雷诺综合征	1
右小腿皮肤软组织损伤	下肢未特指的损伤,水平未特指	1
右侧颌下瘢痕	瘢痕	1
胎儿异常胎儿部分肠管扩张胎儿透明隔腔增宽	先天性透明隔异常	1
脑内出血后遗症	脑出血后遗症	1
慢性家族性良性天疱疮	良性慢性家族性天疱疮	1
双膝软组织挫擦伤	膝部挫伤	1
胆囊腺肌瘤	胆囊肌腺症	1
面部双手双下肢色素沉着待查	皮肤色素沉着	1
右侧眼眶撞伤	眼和眶未特指的损伤	1
交界性黏液性腺纤维瘤	粘液性腺纤维瘤	1
经量减少	月经稀少	1
右上睑部分缺损伴闭合不全	眼睑闭合不全[兔眼]	1
腺样体慢性炎症	扁桃体和腺样体的其他慢性疾病	1
病毒性肝炎慢性丙型	慢性丙型病毒性肝炎	1
左颈淋巴转移癌	颈部淋巴结继发恶性肿瘤	1
左大脑中动脉阻塞或变异	脑血管畸形	1
脊髓灰质炎<脊髓型>	急性脊髓灰质炎	1
右侧额颞枕顶及纵裂池积液	脑积水	1
Poncet综合征不除外	结核性风湿病[篷塞病]	1
鼻眶颅底真菌病	未特指的真菌病	1
预防乙肝	其他特指的预防措施	1
急性肺梗塞	肺梗死	1
上呼吸道感染，腹泻，	上呼吸道感染	1
双耳听力障碍	听功能障碍	1
左尺骨鹰嘴前方撕裂性骨折陈旧性	陈旧性尺骨骨折	1
慢高合并妊娠	妊娠合并慢性高血压	1
重度免疫相关性血细胞减少症	免疫相关性血细胞减少症（IRP）	1
水源性肢端角化	角化病	1
胆管错构瘤可能	胆管错构瘤	1
先天性肺动脉闭锁	肺动脉闭锁	1
宫颈高级别病变CINIII级	子宫颈上皮内瘤变III级[CINIII级]	1
悬雍垂过长	悬雍垂过长	1
1妊娠晚期胎盘组织2脐带间质粘液变	妊娠状态	1
胃多发息肉病	胃息肉	1
骶尾部皮肤II°灼伤	躯干未特指的损伤,水平未特指	1
全脑放疗后	放射治疗	1
肺囊性腺瘤样变	先天性腺瘤样肺囊肿	1
晚孕单肾	妊娠状态	1
指甲异常微量元素缺乏	微量元素缺乏症	1
口周出血点待查	出血斑点	1
右眼睑感染	眼睑未特指的炎症	1
胃窦幽门前区异位胰腺内镜粘膜下剥离术	胃内异位胰腺	1
双侧先天性膑骨关节脱位	髌骨脱位	1
左额叶脑肿胀	脑水肿	1
非酒精性脂肪肝病轻度	脂肪肝	1
性交痛	性交疼痛	1
单眼盲右眼缺如	单眼盲	1
垂体机能减退综合征Simmond病	腺垂体功能减退症	1
复诊T11-12髓内囊肿保守治疗中	脊髓内囊肿	1
肝左叶胆管上皮异型性增生	胆道不典型增生	1
颅内病变性质待查脱髓鞘疾病可能性大	脱髓鞘病	1
db0主气管阻塞db	呼吸道梗阻	1
全身腋窝腹腔颈部下肢淋巴管囊肿	囊性淋巴管瘤	1
右眼虹膜缺如	先天性无虹膜	1
左股骨近端溶骨性破坏	骨质溶解	1
急性粒细胞性白血病M2型缓解期	急性粒细胞性白血病部分分化型伴缓解(M2型)	1
胃窦隆起型病变憩室可能	胃憩室	1
骨关节炎；痹症；肝肾不足	骨关节病	1
精神异常原因待查	精神障碍	1
左膝关节软组织挫伤	膝部挫伤	1
大便质粘不畅	其他大便异常	1
结肠毛细管血管扩张症	胃肠道毛细血管扩张症	1
右小腿截肢肢麻气滞血瘀经络不畅	截肢	1
先天性颅裂枕部脑膜膨出	先天性脑膜膨出	1
髂窝滑囊囊肿	骨盆部囊肿	1
右侧外耳道闭锁2右侧听力障碍	听功能障碍	1
副乳腺(腋下)	副乳	1
下肢周围神经病变	多发性神经病[多发性神经炎/周围神经炎]	1
左膝皮肤破裂伤	下肢撕裂伤	1
肩周炎，局部钙化术后	肩周炎	1
双下肢动脉硬化伴斑块形成	肢体动脉硬化	1
腰4椎体右侧横突骨折	腰椎骨折L4	1
右侧输卵管异位妊娠	输卵管妊娠	1
结膜炎行动不便	结膜炎	1
右心房扩大	心房扩大	1
上唇外伤性色素沉着	色素沉着未特指的疾患	1
右侧小脑半球脑梗死	小脑梗死	1
胸主动脉夹层(DE BAKEYⅢ型)	主动脉夹层B型	1
会阴裂伤I度裂伤	会阴部裂伤	1
直肠肛管内盲瘘	盲管瘘	1
四肢骨痛	骨痛	1
植物状态肌张力增高	肌张力障碍	1
肩手综合症	肩手综合征	1
浸润型中分化腺癌	腺癌	1
右侧鼻腔新生物	鼻腔息肉	1
慢性移植物抗宿主反应腹	慢性移植物抗宿主病	1
海洛因药物瘾	海洛因药物瘾	1
心脏起搏器更换电池	心脏起搏器调整和管理	1
颈部劳损	颈部其他和未特指部位关节和韧带扭伤和劳损	1
肠胃功能失调	胃肠功能紊乱	1
双下肢动脉硬化	肢体动脉硬化	1
宫壁组织显变性并见少量胎盘组织粘连	胎盘粘连不伴出血	1
慢性移植物抗宿主反应病肝脏皮肤口腔	慢性移植物抗宿主病	1
右腰部包块	腰部占位	1
慢性移植物抗宿主反应病胃肠道口腔	慢性移植物抗宿主病	1
颈动脉粥样硬化伴斑块形成	颈动脉粥样硬化	1
腹部膨隆原因待查Cushing综合征	皮质醇增多症[库欣综合征]	1
-子宫内膜增厚	子宫内膜增生	1
全脊髓放疗后	放射治疗	1
克罗恩病（结肠型）	结肠克罗恩病	1
左足第一跖趾关节红肿姆外翻	足拇外翻	1
未分化缔组织病PBC	结缔组织病	1
宫颈高级别上皮内病变CINⅢ级并累及腺体	子宫颈上皮内瘤变III级[CINIII级]	1
慢性移植物抗宿主反应病皮肤口腔	慢性移植物抗宿主病	1
右侧胸水原因待查	胸腔积液	1
移植皮瓣坏死右足底	足坏死	1
子宫内避孕器机械并发症	放置子宫内避孕装置	1
浆乳治疗后	浆细胞性乳腺炎	1
胎膜及脐带未见明显异常胎盘绒毛多灶性梗死	胎盘梗死	1
外院两次B超均提示早孕宫内暗区	妊娠状态	1
单睾症	单侧睾丸缺如	1
重度呼吸睡眠暂停综合症	睡眠呼吸暂停低通气综合征	1
HUNT综合症左化脓性软骨膜炎	拉姆齐-亨特综合征[Ramsy-Hunt综合征]	1
两个或更多手指截断	多指完全离断	1
特指器官后天性缺失左手第2	后天性单侧手指缺失	1
舌腹血管畸形	舌血管畸形	1
脱髓鞘性脑白质病√	脱髓鞘性白质脑病	1
双眼VKH综合征原田氏病	Vogt-小柳原田综合征	1
血管免疫母	血管免疫母细胞性淋巴结病	1
左侧额颞顶硬膜下积液右侧额颞硬膜下积液	硬脑膜下积液	1
冠状动脉前降支中段心肌桥形成	冠状动脉肌桥	1
右上肢肱二头肌部分断裂	肱二头肌肌肉和肌腱损伤	1
额部软组织挫擦伤	头部损伤	1
盘状红斑狼疮	盘状狼疮	1
左手掌皮肤软组织压轧伤	手部挤压伤	1
左侧颈动脉海绵窦瘘	海绵窦动静脉瘘	1
PTCA＋冠状动脉内支架植入术	冠状动脉支架植入术后状态	1
升主动脉-主动脉弓壁间血肿并破裂	主动脉壁内血肿	1
粘膜扁平苔藓伴糜烂	扁平苔癣	1
慢性浅表萎缩性胃炎伴咖啡斑	慢性萎缩性胃炎	1
右下肺送检组织支气管囊性扩张倾向支	支气管扩张症	1
脾脏瘀血性脾肿大	脾大	1
右侧颈内动脉烟雾综合征不除外	烟雾病[脑底异常血管网病]	1
名称子宫下段剖宫产术	无指征剖宫产的单胎分娩	1
双肾多发囊肿伴囊内结石	肾囊肿	1
右侧乳腺外上象限恶性肿瘤	乳腺外上象限恶性肿瘤	1
RSA-2右单角子宫HT细胞免疫紊乱NK	单角子宫	1
膀胱过度活动综合征	膀胱过度活动症	1
左食指中指撕脱性骨折	指骨骨折	1
疑右臀上皮下血肿机化	血肿机化	1
右前臂带状孢疹	带状疱疹	1
右枕部静脉畸形	周围静脉畸形	1
急性无黄疸型戊肝	病毒性肝炎戊型急性无黄疸型	1
上纵隔异常密度影	其他特指身体结构诊断性影像检查的异常所见	1
左小脑半球血管网状细胞病	烟雾病[脑底异常血管网病]	1
1.新生儿溶血病（ABO）	新生儿ABO血型不合溶血病	1
左侧臀部皮脂腺囊肿	皮脂腺囊肿	1
多脏器功能不全循环呼吸胃肠肾脏凝血	多脏器功能障碍综合征[MODS]	1
右眼TERSON综合征	蛛网膜下腔出血并玻璃体出血症[Terson综合征]	1
脊椎多发骨破坏	骨质破坏	1
下肢上皮样肉芽肿性病变伴凝固性坏死右大腿	肉芽肿	1
双下肢行走异常	异常步态	1
右睾丸回缩	回缩睾丸	1
颈动脉椎基动脉及脑动脉粥样硬	颈动脉粥样硬化	1
右腘动脉支架置入术	周围血管支架植入术后状态	1
右侧陈旧性腔隙性脑梗死	腔隙性脑梗死	1
肛周湿疣	肛门生殖器疣	1
胸椎小关节功能紊乱	胸椎小关节功能紊乱	1
左外踝韧带撕脱性骨折	外踝骨折	1
右肺上叶硬结灶性质待查	肺诊断性影像异常	1
内耳眩晕症	耳源性眩晕	1
G2P2孕38+2周宫内妊娠顺娩LOA	头位顺产	1
右下肢肌肉萎缩	下肢肌肉萎缩	1
腰椎同描述考虑为慢性化脓性炎请结合临床	炎性脊椎病	1
远端脾肾分流术后，门静脉高压症	门脉高压	1
右股静脉临时导管置管术已拔除	为肾透析的临时静脉拔管	1
先天性矫正型大血管转位	矫正性大动脉转位	1
慢性胆囊炎急性发作期	慢性胆囊炎急性发作	1
脚软食欲差	食欲不振	1
肺源性心脏病失代偿期	肺源性心脏病	1
绝经后期子宫内膜分泌期改变	绝经期	1
浆细胞性白血病	浆细胞白血病	1
双侧放射冠区及右侧枕部脱髓鞘改变	脱髓鞘性脑病	1
颅内多发缺血性脱髓鞘病变	脱髓鞘病	1
先天性软骨发育不良	软骨发育不全	1
腹腔动脉多发斑块伴管腔狭窄	动脉狭窄	1
多脏器功能不全肾脑心代谢凝血	多脏器功能障碍综合征[MODS]	1
肠病毒性结膜炎	病毒性结膜炎	1
取出右胫骨内固定装置	取出内固定装置	1
先天性胆管囊样扩张症	先天性胆管扩张	1
右手拇指化脓性指头炎	指头炎	1
前列腺囊性占位	前列腺囊肿	1
原发性甲状腺机能亢进症(复发)	原发性甲状腺功能亢进	1
认知功能缺损	认知障碍	1
左颈Castlemen病	Castleman病	1
慢性轻度丙型病毒性肝炎	慢性丙型病毒性肝炎	1
狭颅症(额缝早闭)	颅缝早闭	1
左侧口角区扁平苔藓恶变	扁平苔癣	1
左侧结节性甲状腺肿物	甲状腺肿物	1
慢性肝炎活动性肝炎	慢性活动性肝炎	1
低度鳞状上皮内病变HPV高危型35阳性	人乳头瘤病毒感染	1
双下肢软组织挫伤	下肢未特指的损伤,水平未特指	1
肠肌惹综合症	肠易激综合征	1
右股骨中下段骨折	股骨骨折	1
肝硬化乙肝	乙型肝炎肝硬化	1
孕3产1宫内妊娠38周1天单活胎LOA	孕38周	1
左侧听力损害	听功能障碍	1
下段胸骨及伤口愈合不良	开放性损伤愈合不良	1
髋关节肌腱膜炎	肌腱炎	1
手脚发麻待查周围神经病变	多发性神经病[多发性神经炎/周围神经炎]	1
双眼外直肌后徙术后	眼术后	1
右手桡骨伸直性骨折	桡骨骨折	1
睑肌痉挛	睑痉挛	1
右腕月骨少量碎骨组织部分似坏死改变	骨坏死	1
高血压病Ⅲ期	高血压	1
右踝腱鞘囊肿	腱鞘囊肿	1
新生儿脑损害	新生儿脑病	1
走路差待查小脑发育欠佳	先天性脑发育不全	1
腹膜后肿物肿物	腹膜后肿物	1
右手无力发胀待查神经卡压	肌无力	1
脑卒中后遗症,抑郁症,原发性高血压3级极高危	抑郁症	1
腓总神经炎	下肢单神经炎	1
颈部增生性瘢痕	颈部瘢痕	1
臂丛神经病变	臂丛神经损害	1
左小腿皮肤剥脱撕裂伤	小腿撕脱伤	1
肝动脉灌注化疗后	化学治疗	1
左肱二头肌腱断裂	上肢肌肉肌腱断裂	1
右膝软组织裂伤	下肢撕裂伤	1
头颈外斜待查	斜颈	1
慢性粒-单核细胞白血病	慢性粒单核细胞白血病	1
膝关节外翻	膝外翻	1
颈2椎体及左横突粉粹性骨折	颈椎骨折	1
感觉性多神经病	其他特指的多神经病	1
感染性脑病	中枢神经系统感染	1
先天性骨发育不全	骨骼发育不良	1
病理诊断1左颈鳃裂瘘管符合鳃裂瘘管改变	鳃裂瘘	1
左小腿及左足广泛皮肤软组织剥脱伴缺损	足部软组织撕脱伤	1
纤维脂肪组织灶性坏死伴大量死骨形成	骨坏死	1
瘢痕性秃发烧后	瘢痕性脱发[瘢痕性毛发缺失]	1
急性迟缓性麻痹	弛缓性瘫痪[周围性瘫痪]	1
右踝部感染	感染	1
先天性青光眼	先天性水眼[眼积水]	1
腰4-55－骶1椎间盘突膨出	椎间盘突出	1
左大腿皮肤人咬伤	下肢开放性损伤	1
先天性鳃裂瘘管左先天性第一腮裂瘘管	鳃裂瘘	1
泛发性皮炎	皮炎	1
动脉导管未关闭	动脉导管未闭	1
左下肢恶性纤维组织细胞病	下肢恶性肿瘤	1
肝错构瘤	肝错构瘤	1
溃疡浸润型低分化腺癌	腺癌	1
高级别子宫上皮内病变CINIII	子宫颈上皮内瘤变III级[CINIII级]	1
躯体病样精神障碍	躯体化障碍	1
双膝外侧盘状半月板	先天性盘状半月板	1
桥本低T4拟怀孕	自身免疫性甲状腺炎[桥本病]	1
母体胎膜早破新生儿	胎儿和新生儿受胎膜早破的影响	1
回盲部Crohn病	大肠和小肠克罗恩病	1
左中指远节指骨粗隆内侧缘撕脱性骨折	指骨远节骨折	1
停经37周B超提示胎儿肠管扩张	孕37周	1
高血压慢性肾病	高血压性肾病	1
妊娠期亚临床甲状腺机能减退？	妊娠合并甲状腺功能减退	1
肿瘤标志物异常	肿瘤标记物升高	1
背部色素斑	色素斑	1
1型糖尿病伴有多个并发症	1型糖尿病伴多个并发症	1
膜性肾小球肾病	膜性肾病	1
低钾周瘫	低钾型周期性瘫痪[低血钾性周期性麻痹/家族性周期性瘫痪]	1
异位垂体	垂体异位	1
双髋关节退行性改变	双侧髋关节骨性关节病	1
右肾造瘘术后	肾造口状态	1
右导管内乳头状瘤	导管内乳头状瘤	1
左膝腘窝软组织劳损	膝的其他和未特指部位的扭伤和劳损	1
膝关节交锁待查	膝关节内部紊乱	1
特发性点状白斑	特发性滴状色素减少症	1
血管性认知功能减退	血管性认知功能障碍	1
新生儿缺氧缺血性脑损伤	新生儿缺氧缺血性脑病	1
送检胎盘胎膜组织显退变伴钙盐沉积	钙质沉着症	1
咳嗽（肺气不宣）	咳嗽	1
（左侧臀部）软组织化脓性感染	软组织感染	1
左鼻前庭血管源性肿瘤考虑血管周细胞	鼻部血管瘤	1
类风湿性关节炎重度	类风湿性关节炎	1
腰1-4右侧横突骨折	腰椎多发性骨折	1
右眼眶鼻窦病变待查右上颌骨部分缺失	颌骨缺损	1
一过性意识障碍心源性脑源性待除外	一过性意识丧失	1
急性呼吸窘迫综合症（重度）	急性呼吸窘迫综合征	1
十二指肠钩虫症	十二指肠钩虫病	1
皮肤棘层松解性疾患NOS	其他特指的皮肤棘层松解性疾患	1
骶骨神经纤维瘤	神经纤维瘤病[VonRecklinghausen病]	1
右眼下睑内翻倒睫	倒睫	1
右侧颞叶动静脉畸形	脑动静脉畸形	1
右前臂尺神经血管断裂	血管断裂	1
回肠下端粘膜急慢性炎胃体小片浅表胃粘膜	胃和十二指肠未特指的疾病	1
胸11椎体压缩性改变	胸椎压缩性骨折	1
继发性自身免疫性溶血状态	自身免疫性溶血性贫血	1
慢性嗜酸细胞白血病	慢性嗜酸性粒细胞白血病[高嗜酸性粒细胞增多症]	1
晚孕头围小	妊娠状态	1
妊娠、乙肝5.25	妊娠状态	1
肾区疼痛	疼痛	1
右胫腓神经脱髓鞘改变	脱髓鞘病	1
新生儿狼疮	新生儿狼疮综合征	1
指甲破损并脱位	甲脱离	1
左肾轻-中度受损	肾损伤	1
桥臂脱髓鞘改变	脱髓鞘性脑病	1
下唇色素斑	色素斑	1
右手中指鹅颈畸形	指天鹅颈状变形	1
血管瘤 右侧大腿内侧	肢体血管瘤	1
胎儿异常胎儿双足内翻	先天性内翻足	1
双侧足背软组织劳损	足的其他和未特指部位的扭伤和劳损	1
贲门口病变-恶性病变可能性大	贲门恶性肿瘤	1
强直-阵挛性癫痫	仅全面性强直-阵挛发作的癫痫	1
左颈慢性肉芽肿性炎	肉芽肿	1
双侧踇趾甲下黑斑甲下淤血	色素沉着未特指的疾患	1
唇及颊部扁平苔藓	扁平苔癣	1
溃结全大肠重度活动期	溃疡性结肠炎	1
胫骨下段先天性骨不连	先天性胫骨假关节	1
左乳腺溢血待查	乳头溢液	1
糖尿病(企业慢病)	糖尿病	1
双肺多发异常密度影复诊	肺部阴影	1
取出左胫骨内固定装置	取出内固定装置	1
停经24周B超提示胎儿左侧胸腔内混合回声	孕24周	1
宫颈低级别上皮内病变CINI级	子宫颈上皮瘤样病变[CIN]I级	1
左手腕部扭转	腕关节扭伤	1
双乳炎性病变	乳腺炎	1
外伤后右三叉神经1支损伤	三叉神经损伤	1
纵膈淋巴结慢性炎症	慢性淋巴结炎	1
睾丸动态未定肿瘤	睾丸动态未定或动态未知的肿瘤	1
颈胸椎病损并截瘫	截瘫[双下肢瘫痪]	1
右侧上颌骨骨纤维异样增殖症	颌骨纤维异常增殖症	1
双上腔静脉左上腔静脉异位引流	先天性双上腔静脉	1
外耳道炎，急性	急性外耳道炎	1
右臀部不典型纤维组织瘤	臀部纤维瘤病	1
双肺尖部部分纤维硬结灶性质待查	肺诊断性影像异常	1
左足踝部软组织坏死缺如	足坏死	1
慢性肉芽肿性炎	肉芽肿	1
前降支浅肌桥	冠状动脉肌桥	1
椎动脉支架置入术	血管支架植入术后状态	1
纠正性大动脉转位	矫正性大动脉转位	1
肺纤维化肺右侧斜裂纤维硬结	肺纤维化	1
左膝关节骨关节炎	单侧膝关节骨性关节病	1
早产胎膜早破	胎膜早破	1
非感染性急性1血液系统疾病2风湿性疾病	风湿病	1
原发中枢系统淋巴瘤	淋巴瘤	1
压力性尿失禁(轻度)	压力性尿失禁	1
动脉粥样硬化(颈动脉斑块)	颈动脉粥样硬化	1
心律失常窦性心动过速	窦性心动过速	1
继发性前庭功能损害	前庭功能未特指的疾患	1
两个手指离断伤	仅两个或更多手指创伤性切断(完全)(部分)	1
右锁骨下动脉椎动脉起始处重度狭窄	锁骨下动脉狭窄	1
面部发育畸形	先天性颅面发育不全	1
腿肿	下肢肿胀	1
先天性巨结肠(赫希施普隆氏病)	先天性巨结肠	1
部分性发作继发全面性发作	癫痫	1
四肢发僵原因－椎体外系疾患	肢体僵硬	1
右手掌软组织损伤	手部损伤	1
停经146周B超提示胎儿后颈部多枚囊性	妊娠状态	1
药物性损害	药物不良反应	1
炎症性关节炎	关节炎	1
右面部Mikulicz病	米库利奇病	1
下肢胫前皮肤色素沉着	色素沉着未特指的疾患	1
右上肺磨玻璃小结节	肺占位性病变	1
右足跟麻木3天神经病变	未特指的多神经病	1
直肠肿物性质待查	直肠肿物	1
右侧上额窦炎	鼻窦炎	1
B淋巴母细胞性淋巴瘤4期	B淋巴母细胞性白血病/淋巴瘤	1
高血酯病4高血酯病	高脂血症	1
中重度主动脉反流	主动脉瓣关闭不全	1
腰部皮肤擦伤	躯干浅表擦伤	1
颞部皮肤松弛	面部皮肤松弛	1
功能性吞咽不畅	吞咽困难	1
双侧上颌牙列部分缺失骨量不足	牙列缺失	1
停经234周院外B超提示左侧肾盂增宽	停经	1
阴道前壁重度膨出后壁中度膨出	阴道前后壁脱垂	1
糙皮病	糙皮病[陪粒格/烟酸缺乏]	1
左膝骨关节病	单侧膝关节骨性关节病	1
骶尾部左髋部压迫性溃疡	压疮	1
人工流产伴有组织物滞留	流产	1
智力语言发育差原因待查	言语和语言发育障碍	1
左小腿软组织劳损	累及下肢多个部位的脱位、扭伤和劳损	1
椎间盘脱出症	其他的颈椎间盘移位	1
双眼白内障（未成熟期）	白内障	1
左腘肌腱止点撕脱性骨折	胫骨骨折	1
药物诱导性自身免疫性肝炎	自身免疫性肝炎	1
T45椎体破坏伴全瘫	完全性瘫痪	1
外阴撕裂伤	外阴开放性损伤	1
左拇指指骨基底部陈旧性撕脱性骨折	拇指骨折	1
右侧乳腺积乳囊肿	乳液囊肿	1
慢性淤胆性脾肿大	脾大	1
慢性免疫介导性周围神经病变	免疫相关性周围神经病	1
左侧膝关节放疗后	放射治疗	1
腰椎间盘切除术椎间植骨融合内	腰椎术后	1
双肺纤维灶性质待查	肺诊断性影像异常	1
髋关节挛缩畸形	髋关节僵硬	1
甲状腺压迫综合症	颈交感神经麻痹[霍纳综合征]	1
慢性移植物抗宿主反应病皮肤口腔肝脏	慢性移植物抗宿主病	1
右脚距骨骨裂	距骨骨折	1
左冠支前降支远端心肌桥形成不完全型	冠状动脉肌桥	1
躯体疾病伴发躯体化反应	躯体化障碍	1
皮肤小疖肿治疗后	皮肤疖肿	1
亚急性皮肤型红斑狼疮	皮肤红斑狼疮	1
双眼高压眼底病变I级	高眼压症	1
右手中环指软组织缺损伴骨外露坏死	手坏死	1
乳腺非典型增生	乳腺增生	1
特指再生障碍性贫血	其他特指的再生障碍性贫血	1
急性移植物抗宿主反应病I级皮肤	急性移植物抗宿主病	1
全身多处刀砍伤	刀砍伤加害	1
代谢性骨病右股骨颅骨病变	代谢性骨病	1
母体妊娠糖尿病之新生儿	糖尿病母亲婴儿	1
左眼人工晶体植入状态后囊混浊	人工晶体植入状态	1
遗传性运动神经病	遗传性运动神经元病	1
因子Ⅷ缺乏伴有血管缺陷	凝血因子Ⅶ缺乏	1
高分化脂肪肉瘤	脂肪肉瘤	1
低钙拇外翻	钙代谢紊乱	1
Q-T间期延长综合征	Q-T间期延长	1
眼周外伤	眼和眶未特指的损伤	1
颌下皮瘘	皮肤瘘管	1
经尿道输尿管软镜激光碎石术	输尿管结石	1
胆肠吻合状态	肠吻合状态	1
骨骼发育异常	骨骼发育不良	1
感染(伤口)	开放性损伤伴感染	1
C12病变并髓核压迫症	脊髓压迫症	1
左足成年人柔韧性平足症	扁平足	1
扁桃体占位	口腔和咽喉部占位	1
膝关节后外侧结构损伤	膝关节损伤	1
cGVHD广泛期眼睛口腔肺脏肝脏皮肤	慢性移植物抗宿主病	1
尿不尽尿潜血阳性排尿无力	其他排尿困难	1
右膝后交叉韧带损伤	膝关节后十字韧带损伤	1
乳腺腺泡扩张伴细胞化生	乳腺导管扩张症	1
双侧胸腔积血	血胸	1
无精子症(睾丸活检术)	无精子症	1
6指畸形	多指	1
双手麻木僵硬原因右膝OA	单侧膝关节骨性关节病	1
胸水未见瘤细胞	胸腔积液	1
下肢抽搐查因	不自主运动	1
第1次化疗后	化学治疗	1
先天性三尖瓣发育不良	三尖瓣发育异常	1
右髌骨骨挫伤	髌骨骨折	1
肝右叶巨大HCC	肝细胞癌	1
G骨髓纤维化	原因不明性骨髓纤维化	1
左侧颈内动脉血栓形成	颈内动脉血栓形成	1
回盲部肠外肿瘤	回盲部肿瘤	1
重度慢性牙周炎	慢性牙周炎	1
黄斑病变萎缩	视网膜病	1
宫颈肥厚	子宫颈肥大	1
右手拇指关节皮缺损	皮肤缺损	1
胸腔积血	血胸	1
侵及子宫后壁及双侧肛提肌	子宫继发恶性肿瘤	1
II度II型窦房阻滞	窦房传导阻滞	1
血管免疫母细胞性T细胞淋巴瘤	血管免疫母细胞T细胞淋巴瘤	1
双肺肺炎	肺炎	1
肥大细胞增生症	肥大细胞增生症	1
滋养层肿瘤	滋养细胞病	1
侵及口咽壁、口咽旁	咽部继发恶性肿瘤	1
妊娠39+2周，孕2产1，单活胎，头位，临产	孕39周	1
宫颈CIN2级阴道前后壁膨出	宫颈上皮瘤样病变[CIN]II级	1
双下肢肢端肥大	肢端肥大症	1
双上肺继发性细支气管扩张	支气管扩张症	1
从3米高土坡摔倒致伤	自高处坠落	1
HIV相关性神经疾病	艾滋病[获得性免疫缺陷综合征]	1
子宫增大见节育器影	具有子宫内避孕装置	1
掌指角皮病复诊取药	角化病	1
左膝内侧间室OA内侧半月板脱位	单侧膝关节骨性关节病	1
产后乳汁自出	乳溢	1
先天性卵巢发育不良	特纳综合征[Turner综合征]	1
右上肢肌肉组织慢性炎	肌炎	1
肝门区囊性病灶右肝低密度性质待查	肝囊肿	1
右踝距骨舟骨跖骨异常信号骨梗死可能	骨坏死	1
右手掌骨撕脱性骨折	掌骨骨折	1
左小腿浅静脉血栓，软组织挫伤	下肢静脉血栓形成	1
肝内胆管同描述符合Caroli`s病改变	先天性肝内胆管囊状扩张症[Caroli病]	1
NSE神经元特异性烯醇化酶异常升高	肿瘤标记物升高	1
月经不调肝肾不足	月经紊乱	1
右眼假性剥脱综合症	假性囊膜剥脱综合征	1
退行性心瓣膜病	老年性心脏瓣膜病	1
﻿自身免疫性胃炎	胃炎	1
颅内支架置入术后	血管支架植入术后状态	1
小脑扁桃体下疝畸形ARNOLD-CHIARI畸形	小脑扁桃体下疝畸形[Arnold-Chiari综合征]	1
d副舟骨畸形右侧d	先天性足副舟骨	1
毛发过多	多毛症	1
尿色异常待查，呼吸道感染	呼吸道感染	1
淋巴细胞性白血病？？	淋巴细胞白血病	1
女性盆腔囊肿	盆腔囊肿	1
妊娠合并内科疾病	妊娠状态	1
分叶性肾炎	膜性增殖性肾小球肾炎	1
肝胃不和血脂高	高脂血症	1
牙周感染	牙周炎	1
脐周感染	脐部感染	1
食道反流	胃食管反流	1
停经292周B超提示胎儿左侧颈部无回声区	妊娠状态	1
感音神经性耳聋	感音神经性聋	1
右膝髌上髌内侧滑膜皱襞综合征	膝关节滑膜皱襞综合征	1
节育器宫颈异位嵌顿	避孕环嵌顿	1
左下肢萎缩待查反射性肌萎缩	下肢肌肉萎缩	1
中枢神经系统脱髓鞘疾病	未特指的中枢神经系统脱髓鞘病	1
大血管错位完全性——单纯性	大动脉转位	1
双眼慢性开角型青光眼	开角型青光眼	1
肿瘤(?)	性质未特指的肿瘤	1
史蒂文斯-约翰逊二氏病糜烂性多形	史蒂文斯-约翰逊综合征	1
多囊肝合并感染可能性大	先天性多囊肝	1
闭合性脑外伤1左侧额顶部硬膜外血肿	创伤性硬脑膜外血肿	1
胸椎破坏伴截瘫	截瘫[双下肢瘫痪]	1
慢性肾功不全尿毒症期CKD5期	慢性肾脏病,5期	1
部分性发作继发全身强直阵挛发作	癫痫大发作[全身强直-阵挛性发作]	1
胰腺癌史	胰腺恶性肿瘤史	1
膀胱造瘘管术后	膀胱造口状态	1
四肢皮肤下垂时白斑	白斑病,不可归类在他处者	1
慢性风湿性心脏瓣膜疾病	瓣膜未特指的风湿性心内膜疾病	1
眼球破裂伴眼内组织脱出右	眼球破裂伤	1
牙齿损伤	牙及相关组织损伤	1
眼球内异物	眼球异物	1
右骨盆肿物	骨盆部占位	1
颅内脱髓鞘病变待诊	脱髓鞘病	1
多脏器功能不全心脏肾脏消化道凝血代谢	多脏器功能障碍综合征[MODS]	1
急性轻型胆源性胰腺炎	胆源性胰腺炎	1
咀嚼无力吞咽无力功能性疾病可能性大	吞咽障碍	1
截肢残端处多处三期压疮肩胛部3期压疮	截肢	1
口咽部消化道化学灼伤	消化道化学伤	1
系统性红斑狼疮关节病变	系统性红斑狼疮	1
鼻唇沟注射整形后左眼失明	单眼盲	1
右眼玻璃体出血	玻璃体积血	1
左手第一掌指关节面碎裂并缺损	手部关节骨折	1
腰2椎体良性病变	腰椎病	1
粒细胞减低症	中性粒细胞减少症	1
双肾多发小囊肿后天性	后天性肾囊肿	1
上肢动颈脉内瘘闭塞	人工动静脉瘘闭塞	1
尿路造口术后	泌尿道的其他人工造口状态	1
左内踝关节囊肿	踝关节囊肿	1
单角子宫	单角子宫	1
左前降支中段中度肌桥	冠状动脉肌桥	1
右眼睑色素斑	色素沉着未特指的疾患	1
右手拇指指甲剥脱伴甲床破裂	甲脱离	1
乳头状微癌	乳头状微小癌	1
心脏病神经紊乱型	心脏神经症	1
阵发性心房纤维化颤动	心房颤动[心房纤颤]	1
双侧大隐静脉瓣膜功能不全	下肢静脉功能不全	1
颈脊髓鞭索综合征	颈部脊髓中央损伤综合征	1
左耳后腮裂瘘管	鳃裂瘘	1
背部皮下疖肿	皮肤疖肿	1
胃底胃体隆起性病变查因	胃和十二指肠未特指的疾病	1
联合性免疫缺乏症	联合免疫缺陷病	1
胸背部肌筋膜劳损	背部劳损	1
双颈部淋巴结反应性增生	颈淋巴结肿大	1
扁平苔藓其他的	扁平苔癣	1
脐动脉舒张期血流信号缺失一胎儿	脐血流异常	1
左眼急性视网膜坏死	急性视网膜坏死综合征	1
慢性移植物抗宿主反应病皮肤口腔关节	慢性移植物抗宿主病	1
右肺上叶轻度支气管扩张	支气管扩张症	1
右下腹肌肉慢性炎	肌炎	1
双眼视神经发育迟缓	视神经发育不良	1
C6-7脊髓内脱髓鞘改变	脱髓鞘性脊髓病	1
慢性覅而原先心脏病肺心功能失代偿期	未特指的心脏病	1
其他为胎儿异常和损害给予的孕产妇医疗	为其他(可疑J胎儿异常和损害给予的孕产妇医疗	1
左膝部刺伤	下肢未特指的损伤,水平未特指	1
头颈部软组织劳损	累及头部伴有颈部的脱位、扭伤和劳损	1
门静脉海绵状变性并肝功能-门静脉瘘	门静脉海绵样变	1
肝细胞变性肝细胞及毛细胆管广泛淤胆	胆汁淤积症	1
青年上肢肌肉萎缩	上肢肌肉萎缩	1
胎儿脐血偏高	脐血流比值高	1
左上睑外伤后疤痕左上睑闭眼功能不全	影响眼睑功能的其他疾患	1
咳嗽晕厥	咳嗽晕厥综合征	1
左髋股骨异常纤维增殖症	股骨纤维结构不良	1
急性喉咽炎	未特指的急性咽炎	1
中毒性产后心肌炎	中毒性心肌炎	1
右姆趾远节基地部骨折	拇趾骨折	1
鼻后滴漏综合征	鼻窦滴漏综合征	1
T淋巴母细胞淋巴瘤 IV期	T淋巴母细胞白血病/淋巴瘤	1
脊柱退变形疾病	脊柱骨关节病	1
惊厥(？)	其他和未特指的惊厥	1
取除子宫内节育器	取出子宫内避孕装置	1
躯体神经官能症	其他特指的神经症性障碍	1
双肾高密度影较前增多	泌尿器官诊断性影像检查的异常所见	1
右肘部皮擦伤	上肢浅表擦伤	1
新生儿低球蛋白血症	低丙球蛋白血症	1
舌系带矫正术后	舌术后	1
膝部软组织损伤	下肢未特指的损伤,水平未特指	1
面部皮肤赘生物	皮赘	1
右肺中叶碳末沉着病炭肺	碳末沉着病[炭肺]	1
胎儿左右左心室内强光点	妊娠状态	1
特发性血小板减少性紫癜埃文斯综合征ITP	特发性血小板减少性紫癜	1
左大腿肉芽肿性炎	肉芽肿	1
非胰岛素依赖型糖尿病伴有酮症酸中毒	2型糖尿病性酮症酸中毒	1
视神经发良不良	视神经发育不良	1
溶血原因自身免疫性溶血可能性大	自身免疫病	1
白血病诱导缓解治疗	白血病	1
肺肾阴虚，冠心病	冠状动脉粥样硬化性心脏病	1
胃体萎缩Hp治疗后复查	慢性萎缩性胃炎	1
急性脊髓外伤	脊髓损伤	1
肾血管平滑肌脂肪瘤	肾错构瘤	1
双眼ROPⅢ区3期Plus	早产儿视网膜病	1
病态窦房结综合症专科检查	病态窦房结综合征	1
滋养叶细胞瘤	滋养细胞病	1
脑内多发性缺血性脱髓鞘	脱髓鞘病	1
宫内环移位	避孕环移位	1
切口脂肪液化	手术后切口脂肪液化	1
左第6-8肋腋部及第11肋骨折	四根以上肋骨骨折不伴第一肋骨骨折	1
右膝ACL胫骨止点陈旧性撕脱性骨折	胫骨骨折	1
左冈上肌止点撕脱性骨折	肱骨骨折	1
考虑舌唇黏膜扁平苔藓	口腔扁平苔癣	1
左腿软组织裂伤	下肢未特指的损伤,水平未特指	1
右肾囊肿多发性	肾囊肿	1
龟头型尿道下裂	尿道下裂,龟头的	1
希罗达手足综合症3级希罗达手足综合症3级	化疗药物反应	1
右跟骨劳损	足的其他和未特指部位的扭伤和劳损	1
回肠系膜高侵袭性B细胞源性非霍奇金淋巴瘤II期（Burrkitt淋巴瘤）化疗后	非霍奇金淋巴瘤(B细胞型)	1
外源性皮质功能减退症	其他和未特指的肾上腺皮质功能减退症	1
胎儿完全性大动脉转位伴完整室间隔	完全型大动脉转位	1
文身	纹身	1
多脏器功能障碍呼吸循环肾脏消化血液凝血	多脏器功能障碍综合征[MODS]	1
停经32周B超提示胎儿头围增大	孕32周	1
颈肌抽搐查因	不自主运动	1
先天性颈枕融合	先天性环枕融合	1
左肾静脉畸形	肾血管畸形	1
右肾实质性结节错构瘤	肾错构瘤	1
左下肢肌萎缩	下肢肌肉萎缩	1
左股部病变并膝关节活动受限	骨病变	1
胃角异位胰腺内镜下剥离术ESD后	胃内异位胰腺	1
下腹部扭伤	身体未特指部位的脱位、扭伤和劳损	1
高免疫球蛋白EIGE综合征	高lgE综合征	1
腭部擦伤	口腔和咽喉部损伤	1
动物咬伤	动物咬伤或造成损伤	1
完全性肺静脉异位引流心下型梗阻型	完全性肺静脉异位引流,心下型	1
肝脏肝细胞弥漫性脂肪变性及水样变性	脂肪肝	1
遗传性色素沉着消化道息肉	色素沉着未特指的疾患	1
静脉化疗治疗	化学治疗	1
食积气滞脾胃不和咽炎痹症	咽炎	1
下肢软组织挫伤	下肢未特指的损伤,水平未特指	1
左下肢周围神经病变腰骶病变	多发性神经病[多发性神经炎/周围神经炎]	1
双眼视功能异常	视觉障碍	1
双肺下叶局限性气肿肺间质性改变同前	肺气肿	1
颅内动脉多发斑块伴轻度狭窄	动脉狭窄	1
右大腿血管畸形	下肢血管畸形	1
多脏器功能障碍肝脏肺心脏肾凝血系统	多脏器功能障碍综合征[MODS]	1
过敏性支气管肺曲菌病	变应性支气管肺曲霉病	1
右腕舟骨陈旧性骨不连	舟骨骨折不连接	1
右脚肿块	足肿物	1
腘动脉动脉瘤	腘动脉瘤	1
胫动脉闭塞左胫后动脉中下段右胫后动脉全程	胫后动脉闭塞	1
右侧腋下皮脂腺囊肿	皮脂腺囊肿	1
左臀部皮脂腺囊肿术后	皮脂腺囊肿	1
胃窦部异位胰腺伴部分导管囊状扩张	胃内异位胰腺	1
右前臂软组织劳损	累及上肢多个部位的脱位、扭伤和劳损	1
双眼轮匝肌痉挛	面肌痉挛	1
右侧小脑异常低密度影	颅骨和头诊断性影像检查的异常所见,不可归类在他处者	1
右手掌烫伤	手部烫伤	1
胸椎疼痛	疼痛	1
多发性周围神经损害	多发性神经病[多发性神经炎/周围神经炎]	1
腹痛待查要求取环	腹痛	1
左室增大左室心肌致密化不全	先天性心肌致密化不全	1
急性肠穿孔回肠病变性质待定	肠穿孔	1
腕部黑色素瘤	上肢恶性黑色素瘤	1
外伤，支气管炎	支气管炎	1
后交通动脉瘤术后	后交通动脉动脉瘤	1
左肱骨中下段不全骨裂	肱骨骨折	1
车祸伤:左踝部皮肤软组织撕脱伤伴骨外露	下肢撕脱伤	1
特指口区囊肿新口底	口腔囊肿	1
双下肢大隐筋脉曲张	大隐静脉曲张	1
双膝关节髌上滑膜皱襞综合症	膝关节滑膜皱襞综合征	1
脑底血管环发育变异	脑血管畸形	1
退变性椎间盘病DDD	椎间盘变性	1
顶部头皮放射性坏死缺损	放射性损害	1
缺血性脑改变脑内多发缺血性改变	脑血管供血不足	1
骨髓淋巴细胞增生	淋巴细胞增殖性疾病	1
肥胖症	肥胖	1
左拇外伤术后	手部损伤	1
多发颅内动脉狭窄	动脉狭窄	1
胎儿颅后窝液体增宽胎儿一侧肾缺如	先天性单肾	1
眼底黄斑病变视瞻昏渺	视神经盘的其他疾患	1
糖尿病右下肢坏疽	糖尿病性坏疽	1
双肺多发网格影考虑间质改变可能性大	肺部阴影	1
浸润性突眼	突眼性情况	1
慢性阻塞性心脏病失代偿期	未特指的心脏病	1
颈部粥样斑块硬化症	颈动脉粥样硬化	1
左侧听神经瘤	听神经瘤	1
右侧股骨内侧副韧带止点撕脱性骨折	股骨骨折	1
染色体克氏综合征	克兰费尔特综合征[Klinefelter综合征]	1
胃痛肾虚	胃痛	1
骶椎病马尾神经受损	马尾损伤	1
残冠1##124————##————根尖牙周炎3##————##————	根尖周炎	1
左膝内侧滑膜皱综合征	膝关节滑膜皱襞综合征	1
完全阴道纵隔	阴道纵隔	1
酒精中毒性精神障碍	酒精所致的精神病性障碍	1
非胰岛素依赖型糖尿病	2型糖尿病	1
宫腔粘连	子宫内粘连	1
被汽车碾压右足致伤	足部挤压伤	1
左枕部皮肤划伤	头皮开放性损伤	1
肾组织慢性改变伴球性硬化	肾小球硬化	1
眼部蜂窝织炎	蜂窝织炎	1
霍期金淋巴瘤	霍奇金淋巴瘤	1
认知功能减退	认知障碍	1
重症多型红斑	重症型多形红斑	1
慢性肾脏疾病CKD5级	慢性肾脏病,5期	1
乳纤维瘤	乳腺纤维瘤	1
腰3/4椎间盘膨出；	腰椎间盘移位	1
葡萄糖－6－磷酸脱氢酶缺陷症	葡萄糖-6-磷酸脱氢酶缺乏性贫血	1
左腕关节月骨无菌性坏死伴左腕关节反应性滑	成人腕月骨骨软骨病[成人金伯克病]	1
唇腭裂术后继发畸形	先天性唇裂术后继发畸形	1
左眉弓先天性黑斑胎记	黑色素痣	1
左下肢撞伤	下肢未特指的损伤,水平未特指	1
乳腺动态未定肿瘤	乳房动态未定或动态未知的肿瘤	1
门静脉海绵状变性	门静脉海绵样变	1
右胫骨骨暴露	下肢开放性损伤	1
外阴色素沉积	色素沉着未特指的疾患	1
特殊恐惧症	特定的(孤立的)恐怖	1
窦性不齐左室高电压轻度缺血改变	窦性心律失常	1
肠易激惹综合症	肠易激综合征	1
Ｂ型血友病[克里斯马斯病]	B型血友病	1
头胀头昏	头晕	1
碘131治疗后甲减	碘性甲状腺功能减退	1
腰5左侧椎管峡部不连	腰椎峡部裂	1
左股四头肌腱开放性撕脱性骨折	股骨骨折	1
颈部软组织劳损	肩颈部劳损	1
急性移植物抗宿主反应皮肤肠道	急性移植物抗宿主病	1
左输卵管异位妊娠	输卵管妊娠	1
膀胱颈糜烂	膀胱未特指的疾患	1
鳃裂瘘管术后	鳃裂瘘	1
2型糖尿病足感染	2型糖尿病性下肢感染	1
右耳中重度听力损失左耳极重度听力损失	未特指的听觉丧失	1
鼻咽癌未分化型非角化性癌	鼻咽恶性肿瘤	1
非酒精性单纯性脂肪性肝病	脂肪肝	1
骨折外伤	骨折	1
男性功能减退	未特指的性功能障碍,非由器质性障碍或疾病引起	1
双眼小柳－原田氏综合征	Vogt-小柳原田综合征	1
子宫偏小PCOS	多囊卵巢综合征[Stein-Leventhal综合征]	1
右腿截肢右腿功能障碍	截肢	1
去分化型脂肪肉瘤	脂肪肉瘤	1
菌痢	未特指的细菌性痢疾	1
左侧海马区硬化并萎缩	海马硬化[颞叶内侧硬化]	1
双下肢静脉曲张伴溃疡	静脉曲张合并溃疡	1
胃无力症	胃麻痹	1
右拇指末节骨骺肥大伴指间关节先天性融合	指融合	1
主动脉夹层(III型)	主动脉夹层B型	1
胆汁性肝硬变	胆汁型肝硬化	1
痉挛型脑性瘫	脑性瘫痪[脑瘫]	1
双眼人工晶体植入状态左眼晶体移位	人工晶体脱位	1
中度脾肿大	脾大	1
纵裂胆脂瘤	颅内胆脂瘤	1
不典型帕金森综合征	帕金森综合征	1
右肺下叶小硬结灶性质待查	肺诊断性影像异常	1
右手指骨折	指骨骨折	1
胸段病变伴不全滩	不完全性瘫痪	1
发作性意识不清原因待查心源性	意识障碍	1
1左膝关节外侧不全盘状半月板前角体部Ⅲ°	先天性盘状半月板	1
消化不良(+内脏感觉过敏)	消化不良	1
吞咽梗阻	吞咽困难	1
右侧卵巢输卵管脓肿	输卵管卵巢脓肿	1
吞咽发呛咽梗	吞咽困难	1
双足第5趾外侧皮肤灼伤	足部损伤	1
右足拇趾皮脂腺囊肿	皮脂腺囊肿	1
右输尿管结石右肾积水	肾积水伴输尿管结石	1
右足上皮样瘤	足部良性肿瘤	1
左膝关节滑膜皱襞嵌压	膝关节滑膜皱襞综合征	1
右胸壁脂肪坏死	脂肪坏死	1
右顶脑血管畸形伽马刀治疗后	脑血管畸形	1
妊娠期亚临床甲状腺功能减退	妊娠状态	1
枕叶异常密度影	颅骨和头诊断性影像检查的异常所见,不可归类在他处者	1
右拇多指	多指	1
糖尿病酮症酸中毒	糖尿病性酮症酸中毒	1
急性胆囊炎并胆囊结石	胆囊结石伴急性胆囊炎	1
G1P1孕41+6周宫内妊娠剖宫娩ROA	经未特指的剖宫产术分娩	1
双输尿管积水	输尿管积水	1
胎儿异常永存左上腔泌尿系统异常	永存左上腔静脉	1
食管下段Barrett食管局灶轻度异型	巴氏食管	1
慢性移植物抗宿主反应病皮肤口腔指甲	慢性移植物抗宿主病	1
背部擦伤	躯干浅表擦伤	1
脓毒血症人型葡萄球菌人型亚种	未特指的葡萄球菌性脓毒病	1
胸腹腰臀部多处刀伤	多处损伤	1
组织细胞郎罕细胞增多症	朗格汉斯细胞组织细胞增生症	1
胰腺副肿瘤神经系统综合征	神经系统副肿瘤综合征	1
鞍区结核瘤	结核感染	1
双眼泪道激光术后	眼术后	1
左肾造瘘管口伤口漏尿	肾造口状态	1
粘膜白斑	白斑病,不可归类在他处者	1
肺炎胃肠炎	肺炎	1
左眼软组织挫伤	眼睑及眼周区挫伤	1
早孕子宫较大	妊娠状态	1
桡骨骨折不愈合	桡骨骨折	1
慢性粒细胞性减少症缓解期	中性粒细胞减少症	1
左膝关节滑膜炎	膝关节滑膜炎	1
骶部皮肤擦伤	躯干浅表擦伤	1
右乳见导管扩张伴导管上皮乳头状增生	乳腺导管扩张症	1
阵发性夜间血红蛋白尿(马尔基亚法瓦-米凯利)	阵发性睡眠性血红蛋白尿	1
抽动－多动综合征	抽动秽语综合征	1
右小指无力待查副肿瘤综合症	副肿瘤综合征	1
脑内多发腔隙灶老年性脑改变	腔隙性脑梗死	1
右额叶病灶SRS放疗后	放射治疗	1
肝局灶增生血脂高	高脂血症	1
双侧放射冠侧脑室前后角白质多发缺血梗塞灶	多发性脑梗死	1
右拇趾外伤拔甲术后	足趾损伤	1
T183肾移植后临界性排异反应	肾移植排斥	1
人偏肺病毒阳性	病毒感染	1
乙状结肠病变并不全梗阻	不完全性肠梗阻	1
高血压性心肌病变	高血压性心脏病	1
盆腔内淋巴结继发性恶性肿瘤	盆腔淋巴结继发恶性肿瘤	1
腕手部肌肉和肌腱扭伤	腕和手肌肉和肌腱损伤	1
左耳廓软骨组织部分呈变性改变	骨病变	1
腰骶筋膜炎	筋膜炎	1
主动脉栓塞和血栓形成	主动脉其他和未特指部位的栓塞和血栓形成	1
(GMXS)慢性肾脏病，ckd5期	慢性肾脏病,5期	1
多脏器功能障碍神经系统循环系统凝血功能	多脏器功能障碍综合征[MODS]	1
下颌前庭沟撕裂伤下颌牙龈撕裂伤	口腔和咽喉部损伤	1
粟粒疹	痱子	1
中位心	中位心	1
脐内皮肤黑色素沉着	其他黑色素沉着过度	1
腘绳肌腱膜炎	肌腱炎	1
间断性EP发作3次双下肢挛缩	癫痫	1
鳃裂畸形	先天性鳃裂畸形	1
小肠血管畸形可能	小肠血管畸形	1
多脏器功能不全累及呼吸心肌肝肾凝血代谢等	多脏器功能障碍综合征[MODS]	1
骨纤维性结构不良单骨性右侧腓骨	腓骨纤维结构不良	1
右侧髋臼炎症	髋关节炎	1
耵聍嵌塞	外耳道耵聍栓塞	1
右额颞创伤性硬膜下血肿	创伤性硬脑膜下血肿	1
高位颈髓椎管内占位	椎管占位	1
眼睑组织炎	眼睑未特指的炎症	1
下肢静脉瓣膜功能不全	下肢静脉功能不全	1
酒精中毒？	乙醇中毒	1
原发性醛固酮增生症	原发性醛固酮过多症	1
右腋窝异物院外术后伤口感染	手术后切口感染	1
肺磨玻璃样变待查	肺诊断性影像异常	1
马德隆畸形	马德隆畸形	1
急慢性炎伴淋巴组织增生	淋巴组织增生	1
鞘膜瘤	神经鞘膜瘤	1
全身化疗后	化学治疗	1
眼睑静脉畸形	周围静脉畸形	1
神经原性膀胱(功能不良)	神经源性膀胱	1
右手环指近节指骨基底桡侧骨裂无移位	指骨近节骨折	1
霉菌性足分支菌病	真菌性足菌肿	1
腰椎病胸椎病	腰椎病	1
支气管粘膜色素沉着纤维化症	碳末石末沉着病[煤矽肺]	1
宫内环下移	避孕环移位	1
副肿瘤运动神经元损害	神经系统副肿瘤综合征	1
真菌团倾向曲菌	曲霉菌病	1
肿瘤手术后	性质未特指的肿瘤	1
胃酸返流	反酸	1
反复感染免疫功能紊乱	感染	1
3第1次腹腔化疗后	化学治疗	1
脑神经脱髓鞘样改变	脱髓鞘性脑病	1
左颌下淋巴结炎；咽扁炎；	颌下淋巴结炎	1
复发性右侧硬膜下积血及大脑镰旁右侧积血	硬膜下血肿	1
丝虫性象皮病	丝虫性象皮肿	1
左侧面舌部麻木查因脱髓鞘性	脱髓鞘病	1
左眼先天性血管异常	血管畸形	1
浅表心肌桥	冠状动脉肌桥	1
多脏器功能不全累及循环肾脏心肌凝血功能	多脏器功能障碍综合征[MODS]	1
胎盘后低回声团胎盘早剥	胎盘早期剥离	1
右眼睑皮肤过敏	眼睑变应性皮炎	1
糖尿病痛性神经病变	糖尿病	1
冠状动脉粥样硬化性血管病	冠状动脉粥样硬化	1
MODS心功能肾功能凝血功能	多脏器功能障碍综合征[MODS]	1
腮腺裂伤	口腔和咽喉部损伤	1
多脏器功能不全累及肝脏肾脏凝血心肌呼吸	多脏器功能障碍综合征[MODS]	1
右示指末节缺损毁损伤	手指损伤	1
双胎之一胎儿左心室内强光点	双胎妊娠	1
左手指动脉畸形	周围动脉畸形	1
脑静脉畸形	脑静脉畸形	1
右胫后肌腱部分断裂	踝部胫后肌腱损伤	1
先天性阴茎扭转	阴茎的其他先天性畸形	1
右拇外伤术后	拇指损伤	1
全脑放疗及二次伽马刀治疗后	放射治疗	1
左髂前上棘开放性撕脱性骨折	髂骨骨折	1
免疫相关不良妊娠	妊娠状态	1
髌(骨软)骨软化(待查)	髌骨软骨软化	1
外周神经损害	多发性神经病[多发性神经炎/周围神经炎]	1
糖尿病并眼部病变	未特指的糖尿病伴有眼的并发症	1
少精症睾丸缩小	少精子症	1
双侧睑袋	下睑袋	1
颈椎神经纤维瘤	神经纤维瘤病[VonRecklinghausen病]	1
CGD-MSD-BMT移植后4月	造血干细胞移植状态	1
双侧颈根处及右侧胸壁皮下气肿纵膈积气	纵隔气肿	1
左心室心肌先天性发育不良	左心发育不良综合征	1
小肠炎症性肠病	炎症性肠病	1
肋间软组织劳损	躯干未特指关节和韧带脱位、扭伤和劳损	1
宫内早孕	妊娠状态	1
左眼睑缺损闭合不全	眼睑闭合不全[兔眼]	1
溃疡癌变	溃疡癌变	1
右肾及输尿管结石	肾输尿管结石	1
染色体平衡移位t'13	未特指的染色体异常	1
L12椎管内硬膜外血肿并不全截瘫指数	硬膜外血肿	1
室性自搏心律	室性自搏	1
骨关节病OA	骨关节病	1
1妊4产2妊356周LSA剖宫产单臀	无指征剖宫产的单胎分娩	1
子宫纵隔(不全)	子宫不全纵隔	1
化学灼伤6%面颈部躯干	躯干化学伤	1
左外侧突出型L45膨出	腰椎间盘突出	1
心功能1级(KILLIP分级)	KillipI级	1
右Hoffa骨折切口复位内固定后	股骨髁骨折	1
原发性皮质增多症Cushing病可能性大	皮质醇增多症[库欣综合征]	1
左膝刺伤	下肢未特指的损伤,水平未特指	1
先天发育不良	先天性发育异常	1
纵隔淋巴结恶性肿瘤	未特指的淋巴结恶性肿瘤	1
双侧髂前上脊褥疮双下肢褥疮	压疮	1
晶体缺如	无晶状体眼	1
L5椎体左侧弓峡裂S1隐裂	先天性腰骶椎隐裂	1
左足第2跖趾关节坏死左足平足症	扁平足	1
双足CMT	腓骨肌萎缩	1
b0干骺软骨发育不良症b	干骺端发育不良	1
真菌性眼内炎	感染性眼内炎	1
肺血管畸形	肺血管畸形	1
耳咽管功能下降	咽鼓管功能紊乱	1
反射性躯体神经病	交感神经反射性营养不良	1
左肺上叶舌段部分支气扩张周围少许纤维灶	支气管扩张症	1
宫颈鳞状上皮内瘤变II级	宫颈上皮瘤样病变[CIN]II级	1
自体造血干细胞移植后纵隔右肺门复发	自体造血干细胞移植状态	1
乳腺paget病待除外	乳房佩吉特病	1
放疗后继发不适	放射治	1
中高分化腺癌	腺癌	1
反应性T淋巴细胞增生	淋巴细胞增殖性疾病	1
右手掌离断	手掌开放性损伤	1
眼眶骨瘤	眶骨良性肿瘤	1
良性前列腺组织伴间质慢性炎	慢性前列腺炎	1
新生儿RH溶血	新生儿Rh血型不合溶血病	1
胸10腰骶部放疗后	放射治疗	1
先天性胆道扩张症	先天性胆管扩张	1
右眼裂小待查	睑裂狭小	1
左眼睑皮肤裂伤	眼睑裂伤	1
动物伤	动物咬伤或造成损伤	1
宫颈上皮异常细胞CINI	子宫颈上皮瘤样病变[CIN]I级	1
产前心脏病	未特指的心脏病	1
左眼部挫伤	眼睑及眼周区挫伤	1
右跟骨皮肤软组织缺血坏死	足坏死	1
血液系统受累免疫相关性血小板减低	血小板减少	1
左侧咽部挫裂伤	咽部挫伤	1
双手麻木原因待查周围神经病变可能性大	多发性神经病[多发性神经炎/周围神经炎]	1
左足骨裂	足骨折,未特指	1
十二指肠至空肠粘膜慢性炎粘膜肌层内?	慢性肠炎	1
短暂性缺血性脑病	脑血管供血不足	1
左腕豌豆骨撕脱性骨折	豆骨骨折	1
心脏起搏器心房电极磨损	具有心脏起搏器状态	1
其他诊断2宫颈肥厚	子宫颈肥大	1
右咽鼓管异常	咽鼓管未特指的疾患	1
血三系减低骨髓造血功能低下	全血细胞减少	1
右手腕肿块	腕关节肿物	1
腰4骨破坏	骨质破坏	1
耳廓纤维溜病	纤维瘤病	1
子宫颈上皮内病变III级	子宫颈上皮内瘤变III级[CINIII级]	1
足趾麻木原因待查周围神经病其他	多发性神经病[多发性神经炎/周围神经炎]	1
1双侧侧脑室旁点状脱髓鞘改变	脱髓鞘性脑病	1
肾上腺皮质发育不全	肾上腺发育不良	1
坏死组织及大量真菌菌丝和孢子	真菌感染	1
颈部腮裂瘘残留	鳃裂瘘	1
腰2椎体压缩骨折	腰椎压缩性骨折	1
左腋下淋巴结Castleman病	Castleman病	1
甲旁腺功能低下	甲状腺功能减退	1
左侧椎动脉动脉供血不足	椎-基底动脉供血不全	1
血象升高原因待查1血液系统疾病2其他	血液和造血器官未特指的疾病	1
朗格汉斯细胞增多症鞍区受累肺部浸润	朗格汉斯细胞组织细胞增生症	1
腋窝淋巴结继发癌	腋窝淋巴结继发恶性肿瘤	1
三叉神经特指疾患	未特指的三叉神经疾患	1
右尺侧腕屈肌腱损伤	腕和手指屈肌腱损伤	1
右肾肾小球广泛玻璃样变性	肾小球病	1
溃疡性中分化腺癌	腺癌	1
evens综合症	自身免疫性溶血性贫血	1
肺真菌感染重症	肺真菌感染	1
咽侧感染	感染	1
颅内多发囊虫1纵裂池囊虫	未特指的囊虫病	1
盆腔静脉瘀血症轻度	盆腔静脉充盈综合征	1
宫颈低度病变CINI	子宫颈上皮瘤样病变[CIN]I级	1
继发性自身免疫性甲状腺病甲功正常期	其他特指的甲状腺疾患	1
纤维蛋白原减少症	低纤维蛋白原血症	1
肺曲霉病(?)	肺曲霉菌病	1
克罗恩氏病贯通型轻度回结肠受累	回肠克罗恩病	1
胆栓综合症	胆汁浓缩综合征	1
阴道炎(阴道假丝酵母菌病)	念珠菌性阴道炎	1
左胸壁占位	胸部占位	1
脑炎后遗症	脑炎后综合征	1
脑出血自发性脑室内出血	脑室出血	1
慢性乙肝病毒性肝炎（活动期）	慢性乙型病毒性肝炎	1
肝肾不足视物不清	视觉模糊	1
外源性色素色汗症	色汗症	1
分泌期样子宫内膜伴息肉	子宫息肉	1
耻骨上经膀胱前列腺切除术	前列腺术后	1
硬化性肾小球肾炎	硬化性肾炎	1
坐骨神经炎	下肢单神经炎	1
骨质疏松抽筋	骨质疏松	1
右环指软组织坏死缺损骨外露	手坏死	1
多指[趾]和并指[趾]畸形	多指[趾]和并指[趾]畸形	1
宫颈肿瘤特殊筛选检查	宫颈肿瘤的特殊筛查	1
右侧眼睑皮下静脉畸形	周围静脉畸形	1
1先天性新生儿皮肤缺损	先天性皮肤缺失	1
其他特指的非霍奇金淋巴瘤	其他特指类型的非霍奇金淋巴瘤	1
肉芽肿性血管炎	韦格纳肉芽肿病[WegenersGranulomatosis病]	1
胎盘绒毛部分纤维素样坏死绒毛血管扩张充血	未特指的胎盘疾患	1
停经25周胎儿左手异常	孕25周	1
面部麻木原因待明神经症可能	神经症性障碍	1
腰1椎体及椎弓骨折	腰椎骨折L1	1
游离体骨和软骨结构	关节游离体	1
甲状旁腺功能减退症	甲状旁腺功能减退	1
左足皮肤肿瘤	足部肿瘤	1
念珠菌性外阴阴N92.600道炎	念球菌性外阴炎	1
大血管异位	大动脉转位	1
G4P2孕33+5周宫内妊娠	孕33周	1
全身多发神经纤维瘤病	神经纤维瘤病[VonRecklinghausen病]	1
颈部血粥样管粥样硬化	颈动脉粥样硬化	1
右侧乳房肿块分叶状肿瘤	叶状瘤	1
混合先露大小双	复合先露	1
颅内支架植入术后	血管支架植入术后状态	1
手外伤右手环指	手指损伤	1
右环指伸肌腱中央腱止点撕脱性骨折	指骨骨折	1
特发性脊椎侧凸	脊柱侧弯	1
左肾旋转不良伴缺血性改变	先天性肾旋转不良	1
双足青少年柔韧性平足全身松弛症	扁平足	1
女性中肾管囊肿	女性中肾管囊肿	1
胃肝源性溃疡	胃溃疡	1
胆管上皮乳头状增生伴局部上皮不典型增	胆道不典型增生	1
多发肝低密度灶Caroli病	先天性肝内胆管囊状扩张症[Caroli病]	1
双侧颈内动脉动脉瘤	颈内动脉瘤	1
胼胝体异常信号影性质待定	颅骨和头诊断性影像检查的异常所见,不可归类在他处者	1
完全性阴道纵隔	阴道纵隔	1
右环指末节手指缺损指腹皮肤缺失	皮肤缺损	1
新生儿基底节阴影待查	头部诊断性检查异常	1
左面部皮肤恶性黑素瘤	面部其他和未特指部位的恶性黑色素瘤	1
1型糖尿病性植物神经病变	1型糖尿病性自主神经病	1
下肢动脉硬化症	肢体动脉硬化	1
双眼玻璃体出血	玻璃体积血	1
子宫纤维瘤	纤维瘤	1
双下肢皮肤搔痒症	瘙痒症	1
右腕劳损	累及上肢多个部位的脱位、扭伤和劳损	1
B超提示胎儿单脐动脉双侧肾窦轻度分离	胎儿单脐动脉	1
卵巢异常信号影	其他特指身体结构诊断性影像检查的异常所见	1
退行性心瓣膜病变	心脏瓣膜病	1
右中叶和左上肺下舌段慢性炎症	肺炎	1
CINII级累及腺体可见挖空细胞	宫颈上皮瘤样病变[CIN]II级	1
膝髌下脂肪垫撞击综合征	髌骨后脂肪垫综合征[Hoffa综合征]	1
颈髓脱髓鞘改变	脱髓鞘性脊髓病	1
面部皮肤红肿过敏	过敏反应	1
影像诊断原发性肝晚期家属取药	肝恶性肿瘤	1
胃体下部IIa型病灶并内镜粘膜下剥离术	胃和十二指肠未特指的疾病	1
副乳头	副乳头	1
右手发麻待查桡神经病变	桡神经损害	1
右肾造瘘后	肾造口状态	1
右上肢肌萎缩待查	肌肉萎缩	1
酒精中毒致精神障碍	酒精所致的精神病性障碍	1
不全中隔子宫	子宫不全纵隔	1
右眼球贯通伤	眼球贯通伤不伴有异物	1
卵圆孔未闭发泡实验阳性	卵圆孔未闭	1
右恶性肿瘤的对症治疗鳞癌	鳞状细胞癌	1
鞍区坏死组织不除外寄生虫虫卵	寄生虫病	1
子宫内膜不典型息肉样腺肌瘤	子宫腺肌瘤	1
色素牙	牙齿变色	1
多发张力性水疱右上肢	上肢浅表水疱	1
下肢血管病	周围血管疾病	1
G周宫内妊娠引产后	引产	1
恶性肿瘤的姑息化疗	化学治疗	1
左腋下淋巴结放疗后	放射治疗	1
自身免疫性甲状腺病亚甲减期	甲状腺功能减退	1
偶发房性期前收缩[房性早搏]	房性期前收缩[房性早搏]	1
狼疮足细胞病	系统性红斑狼疮,累及器官或系统	1
G宫内妊娠	妊娠状态	1
肋骨胸椎骨质破坏待查	骨质破坏	1
鼻咽粘膜呈慢性炎免疫组化CK-	慢性鼻咽炎	1
糖尿病性酮酸中毒	糖尿病性酮症酸中毒	1
淋巴细胞减少症	淋巴细胞减少	1
双侧颈内动脉内膜病变伴斑块形成	颈内动脉斑块	1
双下肢肌肉炎症	肌炎	1
双眼渗出液视网膜神经上皮脱离	渗出性视网膜脱离	1
双眼糖尿病性病变	未特指的糖尿病伴有眼的并发症	1
范博盖尔特脑白质病	脑白质病	1
2型糖尿病伴有酮症酸中毒	2型糖尿病性酮症酸中毒	1
右侧肋间血管破裂	血管断裂	1
颏部发育不足	先天性颅面发育不全	1
并周围神经病变并双眼代谢性眼病	多发性神经病[多发性神经炎/周围神经炎]	1
A1B1半脱位A2牙松动	牙脱位	1
双下肢肢体发育不良	先天性发育异常	1
肛瘘（高位？）	高位肛瘘	1
双侧颈动脉内中膜改变伴粥样斑块形成	颈动脉粥样硬化	1
左颈内动脉动脉瘤	颈内动脉瘤	1
溶血性尿毒性综合症	溶血-尿毒综合征	1
四肢无力待诊可逆性血管收缩综合征	肢体无力	1
右足背轧伤	足部挤压伤	1
巨脾脂质组织细胞增多症Gaucher病	脑苷脂贮积综合征[戈谢病]	1
停经303周MR提示胎儿颈椎改变轮状胎盘	妊娠合并轮状胎盘	1
原发中枢神经系统恶性淋巴综合治疗后	淋巴瘤	1
获得性依赖维生素K凝血因子异常症	获得性维生素K依赖因子缺乏症	1
右肾异位肾	肾异位	1
阴道不全纵膈	阴道纵隔	1
疣状血管瘤	血管瘤	1
短肠综合症肠切除后综全症	短肠综合征[肠切除后综合征]	1
右膝前交叉韧带胫骨止点撕脱性骨折	胫骨骨折	1
左足皮肤割伤	足部开放性损伤	1
甲状腺良性滤泡病变	其他特指的甲状腺疾患	1
慢性GVHD肝脏皮肤广泛型	慢性移植物抗宿主病	1
左眼视网膜全部脱离右眼部分脱离	视网膜脱离	1
关节周围软组织挫伤	躯干未特指的损伤,水平未特指	1
左眼角膜间质纤维化伴灶性浅表糜烂	角膜糜烂	1
左附件交界性浆液性肿瘤术后	输卵管及卵巢恶性肿瘤	1
乙型肝炎表面抗原携带者	乙型病毒性肝炎表面抗原携带者	1
鞍区占位性质待查	颅内占位性病变	1
多发性周围神经病营养障碍型	营养性周围神经病	1
左侧颞顶部颅内异常信号影	颅骨和头诊断性影像检查的异常所见,不可归类在他处者	1
患者踢足球时不慎被对方踢倒致伤左踝关节	踝关节损伤	1
短暂性全面性遗忘症	短暂性全面遗忘	1
慢性脱髓鞘性周围神经病	脱髓鞘病	1
醣尿病肾功能轻度降低	未特指的糖尿病伴有肾的并发症	1
肾组织轻微改变伴球性硬化	肾小球硬化	1
血脂高血脂高	高脂血症	1
双眼轻度白内障	白内障	1
右侧多囊卵巢	卵巢多囊样改变	1
髋骨放疗后	放射治疗	1
右侧平足右胫骨远端骨质改变	扁平足	1
视网膜动脉闭塞OD	其他视网膜动脉阻塞	1
右拇短伸肌腱断裂	手部肌肉肌腱断裂	1
停经315周B超提示胎儿胃及部分肠管扩张	妊娠状态	1
双眼睑缘相关性结膜病变双眼慢性睑板腺阻塞	结膜未特指的疾患	1
肝内胆汁淤积综合症	胆汁淤积症	1
双侧输尿管结石并双肾积水	肾积水伴输尿管结石	1
左拇指皮肤软组织缺血坏死	手坏死	1
外阴纤维上皮间质性息肉	外阴皮赘	1
入院心电图：窦性心律，非特异性T波异常	非特异性ST-T改变	1
左颞叶肿物	脑占位性病变	1
大疱表皮样癣性药疹	莱尔综合征[lyell综合征]	1
周身游走性疼痛	疼痛	1
右前臂烧伤2%III°	上肢三度烧伤	1
左腹股沟韧带劳损	腹股沟损伤	1
胎盘绒毛血管增多底板绒毛外滋养细胞增多	未特指的胎盘疾患	1
瘾疹燥灼痒甚下肢麻	瘙痒症	1
左下下颌骨纤维异样增殖症良性	颌骨纤维异常增殖症	1
下丘脑下综合征	下丘脑综合征	1
右上臂麻木,颈椎片显示颈椎病	颈椎病	1
自身免疫性疾病抗AMA-M2抗体阳性	自身免疫病	1
待查右侧睾丸增大稍膜积水	鞘膜积液	1
后枕部头皮压疮并头皮坏死	压疮	1
部分导联T波改变8左房增大	心电图异常	1
重型闭合性颅脑损伤	闭合性颅脑损伤重型	1
双侧听力重度损害	听功能障碍	1
停经31周院外B超提示胎儿盆腔囊性回声	孕31周	1
双侧颈动脉粥样硬化伴右侧斑块形成	颈动脉粥样硬化	1
大疱性表皮坏死松解萎缩型药疹	莱尔综合征[lyell综合征]	1
腰椎病左侧神经根受压	腰椎病	1
左室向心性肥厚左房增大	心室肥厚	1
钙沉着性角膜	角膜带状变性	1
左额硬膜下血肿非创伤性	非创伤性硬脑膜下血肿	1
波状热流产热	布氏杆菌病[波状热]	1
急性移植物抗宿主反应病II度肠道	急性移植物抗宿主病	1
手外伤(针刺伤)	手部开放性损伤	1
左腕正中神经粘连卡压	正中神经卡压综合征	1
1颈髓病变炎性EDSS评分25分	脊髓炎	1
新生儿反应弱肌张力弱原因待查	新生儿未特指的肌张力疾患	1
车祸伤多发骨折	多发性骨折	1
室性自身心律	室性逸搏性心律	1
右髂总静脉血栓形成	髂静脉血栓形成	1
下颌骨发育不全	先天下颌骨颜面发育不全	1
右面部软组织挫裂伤	面部软组织挫伤	1
高血压病并左房增大	高血压	1
Rett综合征	雷特综合征[Retts综合征][脑萎缩性高血氨症]	1
眼部神经挫伤	身体未特指部位的神经损伤	1
慢性糜烂型胃炎	糜烂性胃炎	1
胎儿13-三体型综合征	13-三体综合征[Patau综合征]	1
结核性胸水	结核性胸腔积液	1
车祸伤，左胫骨下段骨折	胫骨远端骨折	1
右足扭伤	足部损伤	1
胎儿宫内生长发育受限	胎儿生长受限	1
免疫风湿性疾病伴肺部侵润	风湿病	1
脾错构瘤	脾错构瘤	1
右足第五跖趾关节脱位	跖趾关节脱位	1
双下肢神经病变	多发性神经病[多发性神经炎/周围神经炎]	1
记忆力减退原因待查短暂性脑缺血可能性大	脑血管供血不足	1
前胸瘢痕疙瘩	瘢痕疙瘩	1
右侧胸腔积血并积气	血气胸	1
左腕软组织割伤	腕部开放性损伤	1
双肺支气管炎可能性大	未特指的支气管肺炎	1
语言发育差查因	言语和语言发育障碍	1
异常子宫出节育环下移	避孕环移位	1
血吸虫肝	血吸虫病	1
上腔静脉阻塞综合症	上腔静脉阻塞综合征	1
特指手术后状态(正颌术后)	其他特指的手术后状态	1
右手指麻木待查高血脂	高脂血症	1
多发子宫肌瘤	子宫多发性平滑肌瘤	1
硬化萎缩性苔藓左腋部复诊	硬化性萎缩性苔癣[白点病]	1
耳带状庖疹	外耳带状疱疹	1
骶尾部符合脊髓栓系-脂肪瘤型	脊髓脂肪瘤	1
肱骨内上髁炎左侧	内侧上髁炎	1
左肺肺炎	肺炎	1
右环指外伤性截指	单指完全离断	1
纵膈淋巴结低分化癌	纵隔淋巴瘤	1
右第1足趾远节趾骨撕脱性骨折	拇趾骨折	1
脓毒症？症状性腹泻	脓毒症	1
肉芽肿性肝炎	肉芽肿性肝炎,不可归类在他处者	1
混合性酸碱平衡紊乱	混合性酸碱平衡失调	1
葡萄酒色痣	鲜红斑痣[葡萄酒色痣]	1
小网膜、胃壁多发淋巴结转移	淋巴结继发恶性肿瘤	1
椎管占位性病变	椎管内占位性病变	1
其他粘液囊囊肿M713臀	其他的粘液囊囊肿	1
左侧隐睾右侧腹股沟斜疝	单侧腹股沟斜疝	1
左大腿皮肤软组织撕脱伴潜行剥离	下肢撕脱伤	1
胸9锥体放疗后	放射治疗	1
停经334周B超提示胎儿后颅凹池扩大	妊娠状态	1
产伤性Ⅱ度会阴裂伤	分娩伴会阴裂伤II度	1
非霍奇金淋巴瘤滤泡向弥漫大B细胞转化	非霍奇金淋巴瘤	1
子宫内膜消融术后	子宫术后	1
先天性喉哮鸣	先天性喉喘鸣	1
表皮葡萄球菌	葡萄球菌感染	1
肝内胆汁淤积	胆汁淤积症	1
一侧肾萎缩	肾萎缩	1
幼年型粒-单核细胞白血病	幼年型粒单核细胞白血病	1
急性淋巴细胞白血液病	急性淋巴细胞白血病	1
矮身材除外克丁病	身材矮小症	1
右颌下粘液囊肿伴导管囊性扩张右颌	下颌下腺粘液囊肿	1
停经243周B超提示胎儿右肾未显影	妊娠状态	1
右小腿筋膜间隙综合征后遗症	下肢骨筋膜室综合征	1
右颞软化己脑后遗症	脑软化	1
右侧额部脑膜瘤	脑膜瘤	1
心功能4级(KILLIP分级)	KillipIV级	1
右输尿管上段结石并右肾重度积水	肾积水伴输尿管结石	1
角膜cashang	角膜擦伤	1
右前降支心肌桥	冠状动脉肌桥	1
血脂升高	高脂血症	1
射精快	早泄	1
大、小网膜及胃壁多发淋巴结转移	多部位淋巴结继发恶性肿瘤	1
全身炎症反应性综合症	全身炎症反应综合征	1
右上肺陈旧病变伴支气管牵拉性扩张	支气管扩张症	1
骶部脊椎裂	骶段脊柱裂	1
右足肿物	足肿物	1
左前臂骨筋膜综合症	上肢骨筋膜室综合征	1
左心收缩功能减弱	心功能不全	1
左侧肩胛骨放疗后	放射治疗	1
淋巴瘤白血病B细胞型	B细胞淋巴瘤	1
左颈部淋巴结Castleman病浆细胞型	Castleman病	1
跖疣冷冻术后	掌跖疣	1
被人击打致伤	被别人殴打、踢、拧、咬或抓伤	1
牙龈创伤	牙及相关组织损伤	1
左腰结节	背部占位	1
手部血管瘤	肢端血管瘤	1
多发性子宫肌瘤伴玻璃样变性	子宫平滑肌瘤	1
左前臂KT综合征	血管骨肥大综合征[Klippel-Trenaunay-Weber综合征]	1
胎盘部分滞留	胎盘部分残留不伴出血	1
先天性右侧Poland综合征	胸大肌缺损并指综合征[Poland综合征]	1
贲门肿瘤,恶性(术后)	贲门恶性肿瘤	1
乳房Paget病待排复诊	乳房佩吉特病	1
右胸壁肿瘤术后	胸壁肿瘤	1
肾虚月经不调	月经紊乱	1
腺癌浸润	腺癌	1
双耳中度听力障碍	听功能障碍	1
脑多发缺血梗塞灶双侧脑室旁半卵圆中心?	多发性脑梗死	1
阴囊不适	不适	1
左侧腰骶部血管性肿瘤	躯干血管瘤	1
周围神经病变尺神经病变	多发性神经病[多发性神经炎/周围神经炎]	1
颈部、腰部外伤	颈部损伤	1
肾错构瘤破裂出血右	肾错构瘤破裂出血	1
面瘫病	神经麻痹	1
右肾血管平滑肌瘤可能	肾错构瘤	1
H59802青睫综合征	青光眼睫状体炎危象[青光眼睫状体炎综合征]	1
牙槽肿物	口腔和咽喉部占位	1
右侧头面部软组织挫伤	头皮挫伤	1
双侧侧脑室前角白质轻度变性7左房增大	脑白质病	1
左侧颈总动脉局部狭窄	颈总动脉狭窄	1
右上颌窦为大量胶原变性组织伴钙盐沉积	钙质沉着症	1
迷路震荡	内耳未特指的疾病	1
双胎之一左心室强光点	双胎妊娠	1
右肾重度积液右侧输尿管重度积液扩张	输尿管扩张	1
符合慢性溶血性脾肿大	脾大	1
直肠下段类癌	类癌瘤	1
高血压病药物控制后血压正常中危	高血压	1
右肘部擦皮伤	上肢浅表擦伤	1
左手指皮肤肿物	皮肤肿物	1
腹腔间室综合症	腹腔筋膜室综合征[腹腔室隔综合征ACS]	1
右眼继发性高眼压	高眼压症	1
肿瘤术后免疫治疗	恶性肿瘤术后免疫治疗	1
左心室高电压T波改变升主动脉增宽	心电图异常	1
慢性肾炎合并妊娠	妊娠合并肾炎	1
二度房室阻滞	二度房室传导阻滞	1
脑血栓	脑血栓形成	1
右侧颈部皮肤肿物	颈部肿物	1
并肝肾综合症	肝肾综合征	1
右膝关节髌下脂肪垫卡压综合症	髌骨后脂肪垫综合征[Hoffa综合征]	1
右室双出口术后	右心室双出口	1
供血不足及脑功能下降	脑血管供血不足	1
周围神经病变桡神经病变右侧	多发性神经病[多发性神经炎/周围神经炎]	1
人工晶体植入右眼	人工晶体植入状态	1
(色素斑)	色素斑	1
病毒性皮肤病	未特指的以皮肤和粘膜损害为特征的病毒性感染	1
亚急性硬膜下血肿	硬膜下血肿	1
冠状动脉微小血管综合症	X综合征	1
手术分娩骶左前位活小婴	无指征剖宫产的单胎分娩	1
双肺肺炎治疗后	肺炎	1
右侧肾上腺醛固酮瘤	康恩综合征[Conn综合征]	1
右颞部皮肤擦伤	头皮擦伤	1
左眼黄斑穿孔	黄斑裂孔	1
双侧髋关节发育性全脱	先天性双侧髋关节脱位	1
脾肿大	脾大	1
右乳纤维囊性增生	乳腺囊性增生病	1
左侧肋骨骨挫伤	肋骨骨折	1
G周妊娠分娩LOA	正常分娩	1
胎儿盆腔异位肾可能	肾异位	1
右肾错构瘤伴部分破裂出血	肾错构瘤	1
语言发育异常	言语和语言发育障碍	1
腹部伤口愈合不良	开放性损伤愈合不良	1
下肢淤血性皮炎双侧	皮炎	1
新生儿血型不合溶血症	新生儿溶血	1
停经271周B超提示胎儿双侧脑室正常高值	妊娠状态	1
GGT高	肝功能异常	1
右下肢血管畸型	下肢血管畸形	1
压缩性骨折(L1、L3)	腰椎压缩性骨折	1
右手示指末节部分坏死伴骨外露	手坏死	1
骶裂	骶段脊柱裂	1
混合型通气功能极重度障碍	通气功能障碍	1
鼻部纤维丘疹病	丘疹	1
右肺上叶恶性肿瘤治疗后的随诊检查	右肺上叶恶性肿瘤	1
产后出血术中	产后即时出血	1
右膝前后交叉韧带损伤	膝关节十字韧带损伤	1
踝关节前踝骨裂	踝关节骨折	1
肾功能检查的异常结果	肾功能不全	1
盆腔放疗后	放射治疗	1
L2椎体压缩性骨折	腰椎压缩性骨折	1
闭塞性动脉粥样硬化症	闭塞性动脉硬化	1
中枢性性早熟单纯乳早发育	中枢性性早熟	1
宫颈cin-3宫腔不均质回声性质待查	子宫颈上皮内瘤变III级[CINIII级]	1
前列腺动态未定肿瘤	前列腺动态未定或动态未知的肿瘤	1
胎儿异常两胎儿胎儿部分肠管扩张	多胎妊娠	1
右外耳道耵聍栓塞	外耳道耵聍栓塞	1
脑A硬化消化障碍	动脉硬化	1
右足第5趾跖关节囊破裂并关节面缺损	跖趾关节损伤	1
运动神经功能损害	运动神经元病	1
左侧颞顶枕部硬膜血肿机化	血肿机化	1
右前臂背伸肌腱陈旧性继裂	上肢肌肉肌腱断裂	1
慢性肺曲霉病急性发作	肺曲霉菌病	1
急性T淋巴细胞白血病伴髓系表达	T淋巴细胞和髓系混合表型急性白血病	1
腰部、骶尾部外伤	下背损伤	1
新生儿细菌性脓毒症	新生儿未特指的细菌性脓毒症	1
横结肠造痿术后	结肠造口状态	1
白斑病	白斑病,不可归类在他处者	1
右侧结节性甲状腺肿伴囊性变	结节性甲状腺肿	1
成骨不全(骨脆症)	成骨不全[脆骨病]	1
活检组织显示B淋巴细胞高度增生	淋巴细胞增殖性疾病	1
并指指融合	并指	1
胎儿宫内死亡	胎死宫内	1
右胫骨骨外露骨不连	胫骨骨折不连接	1
双眼ROPⅡ区1期Plus-	早产儿视网膜病	1
周围神经病变失常	多发性神经病[多发性神经炎/周围神经炎]	1
风心病主动脉瓣狭窄	风湿性主动脉瓣狭窄	1
食欲欠佳	食欲不振	1
牙龈挫伤	牙及相关组织损伤	1
被人用拳头及脚打伤全身多处	多处损伤	1
肌间静脉血栓形成	静脉血栓形成	1
右侧大脑脚囊肿	脑囊肿	1
左示指皮肤缺失伴小片甲床缺损	皮肤缺损	1
化疗相关口腔黏膜及胃肠道损害	化疗药物反应	1
肝内胆汁淤积性黄疸	黄疸	1
颈部左侧结节：急性淋巴结炎	急性淋巴结炎	1
宫颈激光术后	宫颈术后	1
左下肢血管狭窄伴足趾坏死	足坏死	1
帽状腱膜下血肿	头皮血肿	1
腰45椎间盘突出	腰椎间盘突出	1
骨盆骨异常信号影	其他特指身体结构诊断性影像检查的异常所见	1
右侧大脑后动脉粥样硬化	脑动脉粥样硬化	1
先天性房间隔缺损	房间隔缺损	1
肺气肿并肺大疱形成	大疱性肺气肿	1
右手无力待查	肌无力	1
下牙槽神经损伤	身体未特指部位的神经损伤	1
附件转移（Ⅳ期）根治术后（Dixon术）	子宫附件继发恶性肿瘤	1
左下肢大面积软组织撕脱缺损	下肢撕脱伤	1
急性移植物抗宿主反应病4度皮肤肠道肝脏	急性移植物抗宿主病	1
关节固定术后状态	关节固定术状态	1
M蛋白血症意义未明的单株免疫球蛋白血症	意义未明的单克隆丙种球蛋白病	1
颌面畸形	未特指的牙面畸形	1
哮喘(Athmas)	支气管哮喘	1
胎儿异常完全型心内膜垫缺失	完全型心内膜垫缺损	1
肾小球系膜细胞及基质轻度增生	系膜增殖性肾小球肾炎	1
肺曲霉病(拟诊)	肺曲霉菌病	1
糖尿病肾病（原肾）	糖尿病性肾病	1
小肠吸收不良综合征；	肠吸收不良	1
胸12椎体压缩性改变	胸椎压缩性骨折	1
蓝趾指综合征	蓝趾综合征	1
大便次数增多回盲部隆起	大便习惯改变	1
偏执狂	妄想性障碍	1
自身免疫性疾病多脏器受累	自身免疫病	1
双眼视网膜脉络膜病变	分类于他处的疾病引起的脉络膜视网膜疾患	1
结核性软组织炎	结核感染	1
右斜疝嵌顿	单侧嵌顿性腹股沟斜疝	1
左眼永存原始玻璃体增生症	永存原始玻璃体增生症	1
肠系膜区局限性异常密度影	腹部诊断性影像异常	1
交界性先天性大疱性表皮松解症	交界型大疱性表皮松解症	1
宫内感染败血症	败血症	1
右胸内肿块	胸腔肿物	1
妊娠合并肝内胆汁淤积征	妊娠期肝内胆汁淤积症	1
骶尾骨中部骨折	骶骨骨折	1
眼睑出血点待查	出血斑点	1
级高血压极高危组	高血压	1
口腔软组织外伤	口腔和咽喉部损伤	1
慢性胃十二指肠炎	胃十二指肠炎	1
上腹部不适伴隐痛	上腹痛	1
右膝撞伤	下肢其他特指的损伤,水平未特指	1
双眼缺血性综合征	眼缺血综合征	1
肺部结节影待查	肺部阴影	1
G3P1孕39周已产ROA	正常分娩	1
左眼视网膜毛细血管前小动脉阻塞	其他视网膜动脉阻塞	1
语音异常	语音改变	1
单绒毛膜双羊膜囊双胎妊娠;	双胎妊娠	1
左侧颈动脉海绵窦瘘术后	海绵窦动静脉瘘	1
宫颈高级别上皮内病变CINIII级	子宫颈上皮内瘤变III级[CINIII级]	1
先天性胆管囊性扩张症IV型恶性变	先天性胆管扩张	1
局限性寻麻疹	荨麻疹	1
左侧下肢多发A-V瘘	动静脉瘘	1
慢性脑病	未特指的脑病	1
胎膜及脐带未见明显异常胎盘局部梗死	胎盘梗死	1
G2P1孕36周已产LOA	正常分娩	1
婴幼儿肝细胞癌	肝母细胞瘤	1
左侧肾动脉支架植入术后状态	血管支架植入术后状态	1
右侧椎动脉颅内段蛇形夹层改变	颅内椎动脉夹层	1
面部带状庖疹	带状疱疹	1
右手中指远节完全离断	单指完全离断	1
炎症后色素减退.足癣	足癣	1
停经35周MR提示胎儿后颅窝池扩大	孕35周	1
原发性腋窝多汗症	多汗症	1
先天性右室双出口	右心室双出口	1
中度呼吸睡眠暂停综合征	睡眠呼吸暂停低通气综合征	1
颅内多发性病灶囊虫病	囊虫感染	1
宫颈CIN2绝经后期	宫颈上皮瘤样病变[CIN]II级##绝经期	2
慢性胃炎/痔，混合	慢性胃炎##混合痔	2
右乳增生性炎	乳腺增生##乳腺炎	2
右乳浸润性导管癌T3N0M0	乳腺恶性肿瘤##浸润性导管癌	2
皮脂腺囊肿并感染	皮脂腺囊肿##感染	2
1空蝶鞍2脑缺血脱髓鞘	脱髓鞘性脑病##脑血管供血不足	2
子宫纵膈切除术后	子宫纵隔##子宫术后	2
浮肿待查大便改变	水肿##其他大便异常	2
右股骨近端动脉瘤样骨囊肿	股骨骨囊肿##动脉瘤性骨囊肿	2
手术后状态(宫内节育器置入)	具有子宫内避孕装置##其他特指的手术后状态	2
左内踝及外踝撕脱性骨折	外踝骨折##内踝骨折	2
右足舟骨及骰骨撕脱性骨折	足舟骨骨折##骰骨骨折	2
第3腰椎横突骨折	腰椎压缩性骨折##腰椎骨折L3	2
急性化脓性阑尾炎、（肠）麦克儿憩室	急性化脓性阑尾炎##麦克尔憩室	2
皮炎(面部皮炎伴感染)	皮炎##感染	2
左侧胸膜胸壁占位	胸壁占位##胸膜占位	2
细菌口腔炎	口炎##细菌感染	2
上呼吸道的疾病该钙缺乏	其他特指的上呼吸道疾病##钙代谢紊乱	2
应激性溃疡伴上消化道出血	应激性溃疡伴出血##上消化道出血	2
中重度肺高压	中度肺动脉高压##重度肺动脉高压	2
纵膈血肿积气	纵隔气肿##纵隔血肿	2
早孕合泌感	妊娠状态##泌尿系感染	2
多囊肾并出血	先天性多囊肾##肾出血	2
孕38+1周羊水偏少	孕38周##羊水过少	2
全身多脏器功能衰竭心肝肾肺胰腺凝血肠道	凝血功能障碍##多脏器功能障碍综合征[MODS]	2
胃角溃疡型低分化腺癌	胃恶性肿瘤##腺癌	2
乳腺恶性肿瘤综合治疗后的随诊检查	乳腺恶性肿瘤##恶性肿瘤联合治疗后的随诊检查	2
慢性结石性胆囊炎伴胆固醇沉积	胆囊结石伴慢性胆囊炎##胆囊胆固醇沉着症	2
脊髓恶性压迫并截瘫	脊髓压迫症##未特指的截瘫	2
直肠低分化腺癌	直肠恶性肿瘤##腺癌	2
右肾盂输尿管占位	肾占位性病变##输尿管占位性病变	2
右卵巢癌IV期	卵巢恶性肿瘤##癌	2
甲状腺乳头状腺癌	甲状腺恶性肿瘤##乳头状腺癌	2
食管胸中段癌	食管胸中段恶性肿瘤##癌	2
间断眼睑浮肿左下肢轻微浮肿	下肢水肿##眼睑水肿	2
胆管囊肿切除术后	胆管囊肿##胆道术后	2
妊娠瘙痒闰（妊娠合并肝内胆汁淤积症）	妊娠期肝内胆汁淤积症##瘙痒症	2
颅骨巨细胞瘤	骨巨细胞瘤##颅骨良性肿瘤	2
陈旧型心梗心功IV级	心功能IV级(NYHA分级)##陈旧性心肌梗死	2
中枢性低钠低氯	低钠血症##低氯血症	2
法鲁氏四联症艾森曼格氏综合征	法洛四联症##艾森曼格综合征	2
淋巴结病(CASTLEMAN病)	Castleman病##淋巴结病	2
甲状腺良性疾病手术后	未特指的甲状腺疾患##甲状腺术后	2
主动脉瓣及二尖瓣退行性	二尖瓣退行性变##退行性主动脉瓣疾患	2
左下肺CA	左肺下叶恶性肿瘤##癌	2
肺粘液腺癌	肺恶性肿瘤##粘液腺癌	2
两侧基底节腔隙性梗塞	腔隙性脑梗死##基底节脑梗死	2
右足及小腿缺血性坏死有腘窝皮坏死	下肢皮肤坏死##足坏死	2
1十二指肠球部杜氏病	十二指肠球部溃疡##胃粘膜下恒径动脉破裂出血	2
脾静脉内瘤栓	脾静脉栓塞##肿瘤栓子	2
结肠多发管状腺瘤伴高级别上皮内瘤变	结肠良性肿瘤##管状腺瘤	2
膀胱结石取石术后	膀胱结石##膀胱术后	2
阴道腺癌	阴道恶性肿瘤##腺癌	2
节育器异位继发肠壁部分穿孔	避孕环移位##肠穿孔	2
子宫颈中分化鳞癌IIa1期	子宫颈恶性肿瘤##鳞状细胞癌	2
前降支中段心肌桥第一对角支中度狭窄	冠状动脉肌桥##冠状动脉狭窄	2
躯体化障碍重度焦虑抑郁	焦虑状态##抑郁状态	2
脑脱髓鞘改变脑缺血发作	脱髓鞘性脑病##脑血管供血不足	2
非霍奇金淋巴瘤(弥漫大B细胞型淋巴瘤 II期B组 IPI评分2分)	非霍奇金淋巴瘤##弥漫大B细胞淋巴瘤	2
右眼高眼压右眼球结膜淋巴循环障碍	高眼压症##淋巴回流障碍	2
面部白斑原因待查蛔虫症可能	白斑病,不可归类在他处者##蛔虫病	2
左肾结石术后并感染	肾结石##感染	2
皮肤白斑上呼吸道疾病	白斑病,不可归类在他处者##未特指的上呼吸道疾病	2
子宫阔韧带肌瘤	子宫韧带良性肿瘤##肌瘤	2
低中分化子宫内膜样腺癌	子宫内膜样腺癌##子宫内膜恶性肿瘤	2
贲门胃底病变伴狭窄	贲门口狭窄##胃和十二指肠未特指的疾病	2
死胎3胎盘胎膜残留	部分胎盘和胎膜滞留不伴有出血##胎死宫内	2
创伤性急性硬膜外下血肿	急性创伤性硬脊膜下血肿##硬脊膜外血肿	2
额部创伤后不愈	头部损伤##开放性损伤愈合不良	2
脑白质病 脑萎缩	脑萎缩##脑白质病	2
甲型流感病毒肺炎	甲型流感##已知病毒的流感性肺炎	2
贲门癌综合治疗后	贲门恶性肿瘤##癌	2
右髋股撞击症右盂唇撕裂	髋关节撞击综合征##髋部损伤	2
肢端肥大性心肌病扩张性心肌病	肢端肥大症##扩张性心肌病[充血性心肌病]	2
纵隔癌	纵隔恶性肿瘤##癌	2
右手小指瘢痕挛缩伴活动受限	手指瘢痕##瘢痕挛缩	2
右侧鼻腔恶性黑色素瘤	鼻腔恶性肿瘤##黑色素瘤	2
支气管炎,盆腔炎\	支气管炎##女性盆腔炎	2
硬膜外血肿伴不全瘫胸3-5椎体水平	不完全性瘫痪##硬膜外血肿	2
双肺炎症并双侧胸腔积液	肺炎##胸腔积液	2
狼疮相关性肺动脉高压	红斑狼疮##肺动脉高压	2
右肺低分化鳞状细胞癌	右肺恶性肿瘤##鳞状细胞癌	2
右侧乳腺纤维腺瘤	乳腺良性肿瘤##纤维腺瘤	2
1接触性皮炎2唇炎	接触性皮炎##唇炎	2
右肾透明细胞癌T1N0M0	肾恶性肿瘤##透明细胞癌	2
慢性荨麻疹（皮肤划痕征）	慢性荨麻疹##人为性荨麻疹	2
右肾结节查因错构瘤	肾错构瘤##肾占位性病变	2
左大腿左小腿割伤	大腿开放性损伤##小腿开放性损伤	2
双手烧伤后瘢痕挛缩畸形	手部烧伤##瘢痕挛缩	2
大便性状改变原因1肠易激综合症2其他	肠易激综合征##其他大便异常	2
血栓性混合痔	血栓性痔##混合痔	2
椎基底A供血不足胃黏膜撕裂症	椎-基底动脉供血不全##胃损伤	2
胎盘异常帆状胎盘及副胎盘	妊娠合并副胎盘##妊娠合并帆状胎盘	2
海马变性硬化	大脑变性##海马硬化[颞叶内侧硬化]	2
部分小肠切除标本小肠异位胃粘膜和异位胰腺	先天性胃粘膜异位##先天性胰腺异位	2
发热、皮下结节待查，自身炎症性疾病？	发热##皮下结节	2
踝关节骨折脱位	踝关节骨折##踝关节脱位	2
肾上腺继发癌	肾上腺继发恶性肿瘤##转移性癌	2
火焰烧伤左手	手部烧伤##火焰烧伤	2
胸髓病变并不全性截瘫	不完全性瘫痪##截瘫[双下肢瘫痪]	2
阴道前壁脱出II度子宫脱出I度	子宫脱垂I度##阴道前壁脱垂	2
胃角溃疡型管状腺癌（pT4N1M0 IIIa期）	胃恶性肿瘤##管状腺癌	2
双膝关节滑膜软骨瘤病	膝关节滑膜良性肿瘤##软骨瘤病	2
左眼白内障术后	白内障##眼术后	2
低钾低钠血症	低钠血症##低钾血症	2
外周动脉硬化并狭窄	动脉硬化##动脉狭窄	2
口腔灼伤性溃疡	口腔开放性损伤##溃疡性口炎	2
右下肢静脉曲张并血栓形成	下肢静脉曲张##下肢静脉血栓形成	2
皮肤色素沉着原因1Addison病2其他	色素沉着未特指的疾患##艾迪生病[Addisons病]	2
泌尿系统继发癌	泌尿系统继发恶性肿瘤##继发性癌	2
双肺间质性肺疾病并肺纤维化	间质性肺病##肺纤维化	2
右肾错构瘤伴出血	肾错构瘤##肾出血	2
右肺中下叶鳞癌	右肺中下叶恶性肿瘤##鳞状细胞癌	2
继发性凝血机能异常维生素K依赖型	凝血功能异常##维生素K缺乏	2
类风湿性关节炎疼痛	类风湿性关节炎##关节痛	2
骨盆转移癌	盆骨继发恶性肿瘤##转移性癌	2
双肺多发性囊性支扩肺心衰	心力衰竭##支气管扩张症	2
不慎从15m高处坠落伤及头部	头部损伤##自高处坠落	2
慢乙肝丙肝复诊	慢性乙型病毒性肝炎##慢性丙型病毒性肝炎	2
淋巴瘤治疗后的随诊检查	淋巴瘤##淋巴瘤	2
宫颈癌IIB期	子宫颈恶性肿瘤##癌	2
恶性疾病经静脉化疗	部位未特指的恶性肿瘤##化学治疗	2
右舌根鳞状细胞Ca	舌根恶性肿瘤##鳞状细胞癌	2
腮腺多形性腺瘤切除术后	腮腺良性肿瘤##多形性腺瘤	2
淋巴结内淋巴上皮样癌	未特指的淋巴结恶性肿瘤##癌	2
左膝关节创伤性OA伴强直	单侧膝关节骨性关节病##膝关节强硬	2
面部双上肢皮肤抓伤	面部开放性损伤##上肢开放性损伤	2
高铅血症铁低	铅中毒##铁缺乏	2
右半结肠隆起型中分化癌侵及粘膜下层	结肠恶性肿瘤##癌	2
右肾透明细胞癌右肾肿瘤	肾恶性肿瘤##透明细胞癌	2
右腮腺腺泡细胞癌	腮腺恶性肿瘤##腺泡细胞癌	2
贫血原因待查；早孕	贫血##妊娠状态	2
F2胎儿宫内生长受限FGR宫内死亡	胎儿生长受限##胎死宫内	2
睾丸肿瘤化疗	睾丸恶性肿瘤##化学治疗	2
右输卵管高级别浆液性腺癌	输卵管恶性肿瘤##浆液性腺癌	2
包茎球囊扩张术后换药	包茎##阴茎术后	2
急性淋巴细胞白血病B细胞型标危型缓解期	B细胞急性淋巴细胞白血病##急性淋巴细胞白血病伴缓解	2
2型糖尿病性合并正中神经病变	2型糖尿病##正中神经损害	2
卵巢高级别浆液性腺癌III期	卵巢恶性肿瘤##浆液性腺癌	2
颈6-7髓内病变伴脊髓空洞	脊髓空洞症##脊髓病	2
内痔伴出血感染	出血性内痔##感染	2
骨肿瘤放疗	骨恶性肿瘤##恶性肿瘤放疗	2
妊娠合并肝血管瘤	肝血管瘤##妊娠状态	2
肝门部胆管细胞癌	肝恶性肿瘤##肝胆管细胞癌	2
急性广泛前壁ST段抬高型心肌梗死	急性广泛前壁心肌梗死##急性ST段抬高型心肌梗死	2
双肺间质性改变不除外间质纤维化请结合病史	肺间质纤维化##间质性肺病	2
考虑镍性皮炎日光性皮炎	镍变应性接触性皮炎##光照性皮炎	2
脊髓型颈病合并不全瘫	不完全性瘫痪##脊髓型颈椎病	2
左足伤口不愈合	足部开放性损伤##开放性损伤愈合不良	2
三踝骨折术后	三踝骨折##骨折术后	2
卵巢浆液性乳头状腺癌	卵巢恶性肿瘤##乳头状腺癌	2
发热伴抽搐原因待查	发热##不明原因抽搐	2
内侧关节室OA骨梗死	膝骨关节病##骨坏死	2
右踝关节开放性骨折伴脱位	踝关节脱位##踝关节骨折	2
双眼屈光不正(近视)	近视##屈光不正	2
L1-2椎管内神经鞘瘤	神经鞘瘤##椎管内良性肿瘤	2
宫外孕破裂休克	异位妊娠后子宫破裂##休克	2
左臀部Bowen病	鲍恩病##臀部肿瘤	2
多发性梗塞累及脑干	多发性脑梗死##脑干梗死	2
脾稍增大副脾	先天性副脾##脾大	2
左足跟玻璃割伤	足部开放性损伤##玻璃割伤	2
妊娠出血	妊娠状态##出血	2
肋骨瘤可能	肋骨良性肿瘤##骨瘤	2
脊髓圆锥受压并双下肢不全瘫	不完全性瘫痪##脊髓受压	2
结肠肿物术后	结肠肿物##结肠术后	2
小肠闭锁IIIa型并穿孔	先天性小肠闭锁##小肠穿孔	2
骨关节病(髌股关节炎	骨关节病##髌股关节病	2
腹水原因待查肝硬化性腹水可能性大	腹水##肝硬化	2
上消化道出血胃溃疡可能性大	上消化道出血##胃溃疡	2
右尺桡骨粉碎性骨折	尺骨骨折##桡骨骨折	2
肺癌ＩＶ期　卡氏评分８０分	肺恶性肿瘤##癌	2
骶尾部外伤后排便困难	排便困难##骨盆部损伤	2
宫颈管占位、粘膜下肌瘤	子宫粘膜下平滑肌瘤##子宫及附件占位	2
肝曲1管状腺瘤部分腺上皮轻－中度异型增生	结肠肝曲良性肿瘤##管状腺瘤	2
关节炎更综症	关节炎##更年期综合征	2
肛门Paget病	乳房以外的佩吉特病##肛门恶性肿瘤	2
右肺中叶鳞状细胞癌	右肺中叶恶性肿瘤##鳞状细胞癌	2
先天性被动免疫性血小板减少症	先天性血小板减少##免疫性血小板减少	2
不慎摔倒致左髋部着地受伤	髋部损伤##摔伤	2
膝关节腘窝囊肿	膝关节囊肿##腘窝囊肿	2
颈腋下淋巴结大待查	颈淋巴结肿大##腋下淋巴结肿大	2
右肱骨头坏死半脱位	肱骨头缺血性坏死##髋关节半脱位	2
右半结肠腺癌	结肠恶性肿瘤##腺癌	2
食管颈段鳞状细胞癌	食管颈部恶性肿瘤##鳞状细胞癌	2
急性心梗继发心衰	急性心肌梗死##急性心力衰竭	2
直肠中-高分化腺癌CTXNXM1BIVB期	直肠恶性肿瘤##腺癌	2
十二指肠球部狭窄并不全梗阻	十二指肠狭窄##不完全性肠梗阻	2
支扩伴感染胸水	支气管扩张症合并感染##胸腔积液	2
缺铁;卵圆孔未闭	铁缺乏##卵圆孔未闭	2
肝脏肿物切除术后	肝肿物##肝术后	2
无月经待诊多囊卵巢综合症	闭经##多囊卵巢综合征[Stein-Leventhal综合征]	2
(R50.900)发热不除外感染性发热	发热##感染性发热	2
食管下段鳞状细胞癌	食管下三分之一的恶性肿瘤##鳞状细胞癌	2
胆囊腺癌	胆囊恶性肿瘤##腺癌	2
慢性心功能衰竭心功能II级NYHA	心功能Ⅱ级(NYHA分级)##慢性心力衰竭	2
大腿软组织肉瘤	下肢恶性肿瘤##软组织肉瘤	2
腰椎压缩性骨折术后	腰椎压缩性骨折##骨折术后	2
前列腺特指疾病高PSA血症	PSA升高##前列腺其他特指的疾患	2
腰痛(泌尿系统结石?)	腰痛##泌尿系结石	2
胆总管囊肿(术后)	胆总管囊肿##胆道术后	2
血液透析导管相关性感染	透析导管引起的机械性并发症##血管导管相关性感染	2
肾结石高脂血症痰湿血瘀阻络	肾结石##高脂血症	2
左髋髂骨撕脱性骨折	髂骨骨折##髋关节骨折	2
左前降支中段心肌桥伴轻度狭窄	冠状动脉肌桥##冠状动脉狭窄	2
脑内多发腔隙性梗塞	腔隙性脑梗死##多发性脑梗死	2
左手鸟养伤	被其他哺乳动物咬伤或抓伤,在未特指场所##手部损伤	2
右肺下叶腺癌IVA期	右肺下叶恶性肿瘤##腺癌	2
乳腺癌(左侧)	乳腺恶性肿瘤##癌	2
肝癌晚期	肝恶性肿瘤##癌	2
回盲部低分化腺癌	腺癌##回盲部恶性肿瘤	2
乙状结肠管状腺癌	乙状结肠恶性肿瘤##管状腺癌	2
支气管扩张并感染右肺下叶不张	支气管扩张症合并感染##肺不张	2
主动脉中度关闭不全伴轻度狭窄	动脉狭窄##主动脉瓣关闭不全	2
舌下神经瘤	神经瘤##舌下神经良性肿瘤	2
肝右外叶肝细胞癌	肝细胞癌##肝细胞癌	2
双侧卵巢中低分化腺癌IIb2期	卵巢恶性肿瘤##腺癌	2
上唇基底细胞癌	唇恶性肿瘤##癌	2
多发椎体骨质破坏并不全瘫	不完全性瘫痪##骨质破坏	2
右跟骨尤文肉瘤	尤因肉瘤##跟骨恶性肿瘤	2
双眼闭角型青光眼（虹膜激光周切术后）	闭角型青光眼##眼术后	2
双侧跟腱类风湿性腱膜炎	跟腱炎##类风湿性关节炎	2
甲状腺右侧叶腺瘤可能	甲状腺良性肿瘤##腺瘤	2
右足背玻璃割伤	足部开放性损伤##玻璃割伤	2
腹膜后小细胞恶性肿瘤	腹膜后恶性肿瘤##小细胞型恶性肿瘤	2
食道胃底静脉中度曲张	胃底静脉曲张##食管静脉曲张	2
电弧烧伤双手	手部烧伤##电流引起烧伤	2
膜性肾病不除外乙型肝炎病毒相关性肾炎	膜性肾病##乙型肝炎相关性肾炎	2
双足坏疽伴感染	下肢坏疽##感染	2
运动发育迟缓歌舞伎综合症	发育迟滞##歌舞伎面谱综合征[Kabuki综合征]	2
泌尿系统疾病高PSA血症	PSA升高##泌尿系统未特指的疾患	2
甲亢免疫性甲状腺炎？	甲状腺功能亢进症##自身免疫性甲状腺炎[桥本病]	2
双下肢浮肿原因淋巴回流障碍	下肢水肿##淋巴回流障碍	2
神经系统特指疾患双侧额叶斑片状高信号影	神经系统的其他疾患,不可归类在他处者##中枢神经系统诊断性影像检查的其他异常所见	2
胸5-7椎体病变并不全瘫	颈椎病##不完全性瘫痪	2
腮弓综合症附耳双	先天性副耳##第一、二鳃弓综合征[Goldenhar综合征]	2
胃窦低级别腺管状腺瘤未累及切面	胃良性肿瘤##管状腺瘤	2
进镜距肛门20cm处管状腺瘤	管状腺瘤##乙状结肠良性肿瘤	2
浅表性威严伴糜烂	慢性浅表性胃炎##糜烂性胃炎	2
1脑缺血脱髓鞘2心肌缺血	脱髓鞘性脑病##心肌供血不足	2
肱骨近端骨折(左侧,术后)	肱骨近端骨折##骨折术后	2
双膝骨关节炎，双膝滑膜炎，半月板损伤	膝骨关节病##膝关节滑膜炎	2
宫颈腺癌，低分化	子宫颈恶性肿瘤##腺癌	2
血脂高头闷晕	血脂异常##头晕	2
右乳乳腺浸润性导管癌	乳腺恶性肿瘤##浸润性导管癌	2
腹腔继发恶性肿瘤放疗后	腹腔继发恶性肿瘤##恶性肿瘤放疗	2
37周疤痕子宫高年胎儿染色体意义不明	瘢痕子宫##妊娠状态	2
食管癌根治术	食管恶性肿瘤##癌	2
创伤性硬脑膜下出肿伴开放性颅内伤口	颅脑开放性损伤伴颅内损伤##创伤性硬脑膜下血肿	2
系统性红斑狼疮狼疮肾炎	系统性红斑狼疮##狼疮性肾炎	2
左眼黄斑劈裂伴视网膜浅脱离	视网膜劈裂症##视网膜脱离	2
肺结节(右肺实性结节，慢性炎症？)	肺占位性病变##肺炎	2
双侧乳腺增生左侧乳腺实性结节	乳腺增生##乳房结节	2
部分发作继发全身发作	癫痫部分性发作##癫痫大发作状态	2
慢性粒细胞白血病不典型	慢性粒细胞性白血病##慢性粒细胞白血病	2
右腹膜后鳞状细胞癌	腹膜后恶性肿瘤##鳞状细胞癌	2
子宫颈中低分化鳞状细胞癌	子宫颈恶性肿瘤##鳞状细胞癌	2
起搏器囊袋感染清创术后	清创术后##心脏电子装置囊袋感染	2
低钾低氯待查	低钾血症##低氯血症	2
高甘油三酯脂血症前列腺梗阻未特指	前列腺未特指的疾患##高甘油三酯血症	2
左下肢无力儿麻后遗症	肢体无力##脊髓灰质炎后遗症	2
轻度“0”形腿消化功能差多汗缺锌	锌缺乏##多汗症	2
腰骶部臀部外伤	下背损伤##臀部软组织损伤	2
重度骨关节炎(腘窝囊肿)	腘窝囊肿##重度骨关节病	2
右膝重度OA左膝OA重度OP	双侧膝关节骨性关节病##重度骨质疏松	2
子宫内膜癌I期	子宫内膜样癌##子宫恶性肿瘤	2
右肺下叶中分化鳞状细胞癌	右肺下叶恶性肿瘤##鳞状细胞癌	2
右侧卵巢浆液性腺癌	卵巢恶性肿瘤##浆液性腺癌	2
胸部枪伤	胸部开放性损伤##枪击伤	2
右乳腺纤维瘤切除术后	乳腺术后##乳腺纤维瘤	2
咽部乳头状瘤	咽良性肿瘤##乳头状瘤	2
右下肢腘动脉血栓栓塞	腘动脉血栓形成##腘动脉栓塞	2
淤血性脾肿大灶性钙盐沉积	脾大##钙质沉着症	2
甲状腺乳头状微小癌	甲状腺恶性肿瘤##乳头状微小癌	2
停经256周B超提示胎儿双足内翻状态	妊娠状态##先天性内翻足	2
躯体化功能障碍周围神经病变	多发性神经病[多发性神经炎/周围神经炎]##躯体性机能障碍	2
不全性粘连性肠梗组	不完全性肠梗阻##粘连性肠梗阻	2
脑血管病(脑供血不足)	脑血管供血不足##脑血管病	2
1.颈部淋巴结肿物待查2.支气管炎;	颈淋巴结肿大##支气管炎	2
颈腰椎间盘多发性膨出	其他特指的椎间盘移位##腰椎间盘移位	2
结肠管状腺瘤直肠绒毛-管状腺瘤	结肠良性肿瘤##管状腺瘤	2
右腘窝疤痕挛缩	瘢痕挛缩##下肢瘢痕	2
右肺腺癌综合治疗后	右肺恶性肿瘤##腺癌	2
颈腰部软组织劳损	肩颈部劳损##腰部劳损	2
颈椎硬膜外血肿并截瘫	未特指的截瘫##硬脊膜外血肿	2
植物神经紊乱躯体化功能障碍	植物神经功能紊乱##躯体化障碍	2
肝恶性肿瘤射频消融治疗	肝恶性肿瘤##射频消融术后	2
上睑粘液癌()	眼睑恶性肿瘤##粘液癌	2
胰头中分化腺癌	胰头恶性肿瘤##腺癌	2
双乳腺增生并右乳囊肿形成	乳腺增生##乳腺囊肿	2
前列腺增生切除术后	前列腺增生##前列腺术后	2
左内踝玻璃割伤	踝部开放性损伤##玻璃割伤	2
桥本氏甲状腺病3梅尼尔综合征	自身免疫性甲状腺炎[桥本病]##梅尼埃病	2
球菌性龈口炎	口炎##细菌感染	2
颈部粥样硬化伴狭窄	颈动脉狭窄##颈动脉粥样硬化	2
胃底中分化腺癌	胃底恶性肿瘤##腺癌	2
非霍奇金弥漫大B细胞淋巴瘤IIIA	非霍奇金淋巴瘤##弥漫大B细胞淋巴瘤	2
左髋股骨囊性变	股骨骨囊肿##髋部囊肿	2
脑心血管病	脑血管病##未特指的心血管疾病	2
高尿酸高粘滞血症尿感	高粘稠血症##高尿酸血症	2
耳部恶性肿瘤	恶性肿瘤##耳部肿瘤	2
1.大便异常待诊：肠肿瘤？直肠炎？炎症性肠病？	其他大便异常##直肠炎	2
-横结肠绒毛管状腺瘤	横结肠良性肿瘤##管状绒毛状腺瘤	2
子宫颈中分化鳞癌IIb期放射治疗	子宫颈恶性肿瘤##鳞状细胞癌	2
十二指肠癌	十二指肠恶性肿瘤##癌	2
脑梗死后出血	脑梗死##脑出血	2
卵巢良性畸胎瘤	卵巢良性肿瘤##良性畸胎瘤	2
原发退变性胸腰椎侧凸	脊柱侧弯##脊椎退行性病变	2
早孕；牙痛	妊娠状态##牙痛	2
抑郁伴躯体形式障碍未特指的	抑郁发作##未特指的躯体形式障碍	2
全身多发转移癌复治	多部位继发恶性肿瘤##转移性癌	2
二尖瓣主动脉瓣为钙化及玻璃样变的瓣	主动脉瓣钙化##二尖瓣钙化	2
主观性头昏重度焦虑伴躯体化	头晕##焦虑状态	2
原发性不孕-输卵管因素	原发不孕##输卵管起因的女性不孕症	2
(十二指肠壶腹部癌)	法特壶腹恶性肿瘤##癌	2
左足跟部皮肤撕脱坏死	足部软组织撕脱伤##足坏死	2
呼吸道感染（过敏性咳嗽）	呼吸道感染##咳嗽	2
眶内癌	眶内恶性肿瘤##癌	2
右中环指末节挤压离断伤	手指挤压伤##手指开放性损伤	2
胃窦腺癌	胃窦恶性肿瘤##腺癌	2
右乳恶性肿瘤放疗	乳腺恶性肿瘤##恶性肿瘤放疗	2
老年性脑改变粥样硬化	脑动脉粥样硬化##老年性脑变性	2
高甘油三酯脂血症心脏病未特指	高甘油三酯血症##未特指的心脏病	2
甲状腺双侧叶乳头状癌	甲状腺乳头状癌##甲状腺恶性肿瘤	2
右乳伤口愈合不良	乳房开放性损伤##开放性损伤愈合不良	2
子宫内膜低分化子宫内膜样腺癌	子宫内膜恶性肿瘤##子宫内膜样腺癌	2
咽部异物划伤	咽内异物##咽喉损伤	2
L2腰椎陈旧性骨折	陈旧性腰椎骨折##腰椎骨折L2	2
头昏反复发作左肢麻木无力	肢体无力##头晕	2
子宫恶性潜能未定肌瘤	子宫平滑肌瘤##潜在恶性未肯定的平滑肌瘤	2
双神经性聋左耳混合聋	双侧感音神经性聋##单侧混合性聋	2
空肠中段粘膜病变并狭窄	肠未特指的疾病##肠狭窄	2
失眠(神经衰弱)	神经衰弱##失眠	2
室管膜瘤术后	室管膜瘤##脑术后	2
右肺中叶肺癌	右肺中叶恶性肿瘤##癌	2
双肺陈旧性病变慢阻肺急发	肺病##慢性阻塞性肺疾病急性加重	2
右中叶MIA右下肺MIA	右肺中下叶恶性肿瘤##腺癌	2
卵巢颗粒细胞癌	卵巢恶性肿瘤##颗粒细胞癌	2
周围型肺癌可能大	肺恶性肿瘤##癌	2
额叶多发脑腔隙灶伴缺血	脑血管供血不足##腔隙性脑梗死	2
胸水查见腺癌细胞	恶性胸腔积液##腺癌	2
右髌骨软化右股骨外髁上方局灶性囊性变	髌骨软骨软化##股骨骨囊肿	2
前列腺肥大伴小囊肿	前列腺增生##前列腺囊肿	2
免疫力低、前列腺肥大、皮炎	前列腺增生##皮炎	2
糖尿病足-右足感染	糖尿病足##感染	2
结肠平滑肌瘤	平滑肌瘤##结肠良性肿瘤	2
右侧卵巢卵泡膜纤维瘤	纤维卵泡膜细胞瘤##卵巢良性肿瘤	2
孕1产0孕38+1周待产胎膜早破	孕38周##胎膜早破	2
右侧顶枕区病变脱髓鞘脑缺血	脱髓鞘性脑病##脑血管供血不足	2
鼻咽未分化型非角化性癌综合治疗后	鼻咽恶性肿瘤##未分化的癌	2
鼻咽癌放脑病	鼻咽恶性肿瘤##放射性脑病	2
右前臂刀刺伤	前臂开放性损伤##刀刺伤	2
全身多处火焰烧伤	火焰烧伤##多处烧伤	2
腹膜后平滑肌肉瘤	腹膜后恶性肿瘤##平滑肌肉瘤	2
降结肠直肠管状腺瘤低级别	降结肠良性肿瘤##管状腺瘤	2
阴道真菌月经不调	月经紊乱##真菌性阴道炎	2
不育睾丸内硬结	男性不育症##睾丸结节	2
银屑病玫糠伴化脓	银屑病##玫瑰糠疹	2
腹腔淋巴结继发癌	腹腔淋巴结继发恶性肿瘤##癌	2
慢性肾脏病矿物质和骨异常	慢性肾病##矿物质代谢紊乱	2
脑病并吞咽功能丧失	未特指的脑病##吞咽障碍	2
盆腔包块（1.卵巢囊肿2.其他）	盆腔肿物##卵巢囊肿	2
肺浸润性腺癌	肺继发恶性肿瘤##腺癌	2
低锌肛周裂口	锌缺乏##肛裂	2
心律不齐房颤	心律失常##心房颤动[心房纤颤]	2
子宫内膜低分化伴神经内分泌分化腺癌	子宫内膜恶性肿瘤##伴有神经内分泌分化腺癌	2
右侧卵巢囊肿术后	卵巢囊肿##卵巢术后	2
右卵巢子宫内膜样腺癌	卵巢恶性肿瘤##子宫内膜样腺癌	2
腺泡状横纹肌肉瘤	软组织腺泡状肉瘤##横纹肌肉瘤	2
醉酒胰腺炎	乙醇中毒##胰腺炎	2
走路不稳双手无力原因待查格林巴利综合征	肌无力##吉兰-巴雷综合征	2
胸腰椎退行性病变	腰椎退行性病变##胸椎退行性病变	2
子宫内膜透明细胞癌Ia期	子宫内膜恶性肿瘤##透明细胞癌	2
外阴病毒感染	病毒感染##会阴部软组织感染	2
右手舟骨月骨脱位伴月骨坏死	腕舟骨脱位##月骨缺血性坏死	2
慢性肾功能不全冠状动脉粥样硬化性心	慢性肾功能不全##冠状动脉粥样硬化性心脏病	2
宫颈癌I期	子宫颈恶性肿瘤##癌	2
左腹部臀部肿瘤	腹部肿瘤##臀部肿瘤	2
粒缺期发热	粒细胞缺乏##发热	2
甲状腺低分化癌	甲状腺恶性肿瘤##癌	2
(左侧上颌窦）炎性息肉	上颌窦息肉##炎性息肉	2
右下肺中心型小细胞肺癌	右肺下叶恶性肿瘤##小细胞癌	2
右侧颞叶及基底节区脑出血	颞叶出血##基底节出血	2
病脑视幻	病毒性脑炎##幻视	2
导管轻度扩张伴局部导管上皮乳头状增生	乳腺导管扩张症##乳腺增生	2
左额顶叶脑挫裂伴血肿形成	多发性大脑挫裂伤##多发性大脑血肿	2
糖尿病并泌尿系感染	泌尿系感染##糖尿病	2
甲状腺滤泡性腺瘤伴出血囊性变	甲状腺良性肿瘤##滤泡性腺瘤	2
面部双手多处划伤	面部开放性损伤##手部开放性损伤	2
腹腔内肉瘤	腹部恶性肿瘤##肉瘤	2
尺桡骨折骨不连	尺骨骨折不连接##桡骨骨折不连接	2
右侧小脑半球大面积脑梗塞	小脑梗死##大面积脑梗死	2
急性ST段抬高型心肌梗死下壁	急性ST段抬高型心肌梗死##急性下壁心肌梗死	2
原发性肝癌介入治疗后	肝恶性肿瘤##癌	2
隐匿性乳腺癌	乳腺恶性肿瘤##癌	2
双下肢感觉肌力异常大小便障碍	排便困难##排尿困难	2
心功能不全急性心肌损伤	心功能不全##心肌损害	2
4慢性肺心病心功能3级	慢性肺源性心脏病##心功能III级(NYHA分级)	2
臀部鞘膜瘤	神经鞘膜瘤##臀部肿瘤	2
四肢肌力下降原因待查格林巴利综合症	肌张力障碍##吉兰-巴雷综合征	2
关节病,动脉粥样硬化,腹泻	关节病##动脉粥样硬化	2
A2B1半脱位A1根折	牙脱位##牙折断	2
G1P0孕37+2周临产LOA,中度贫血	孕37周##中度贫血	2
乳癌复诊	乳腺恶性肿瘤##癌	2
结肠绒毛-管状腺瘤伴有局部上皮内瘤变	结肠良性肿瘤##管状腺瘤	2
纵隔肿瘤放疗	纵隔恶性肿瘤##恶性肿瘤放疗	2
早泄腰痛及右睾丸	早泄##腰痛	2
右甲状旁腺腺瘤	甲状旁腺良性肿瘤##腺瘤	2
右下肺癌、肺结核（-）	右肺下叶恶性肿瘤##癌	2
右腕部胡蜂蜇伤	蜂螫伤##腕部损伤	2
左侧冠脉扩张心功能0级	冠状动脉扩张##心功能不全	2
腰45轻度不稳伴轻度退变	腰椎不稳定##腰椎退行性病变	2
猩红热心肌炎	猩红热##心肌炎	2
双卵巢白体右输卵管慢性炎伴管腔扩	输卵管卵巢炎##输卵管狭窄	2
导管内乳头状瘤右乳	乳腺良性肿瘤##导管内乳头状瘤	2
右乳中分化浸润性导管癌	乳腺恶性肿瘤##浸润性导管癌	2
双侧乳糜血尿	乳糜尿##血尿	2
美尼尔氏综合症膜迷路积水	膜迷路积水##梅尼埃病	2
直肠粘膜低级别管状腺瘤	直肠良性肿瘤##管状腺瘤	2
横结肠癌	横结肠恶性肿瘤##癌	2
胃窦病分化腺癌	胃窦恶性肿瘤##腺癌	2
胸椎骨质破坏并不全瘫	不完全性瘫痪##骨质破坏	2
左肺小细胞Ca广泛期	左肺恶性肿瘤##小细胞癌	2
子宫内膜腺鳞癌	子宫内膜恶性肿瘤##腺鳞癌	2
骶骨小细胞癌	骶骨恶性肿瘤##小细胞癌	2
弥漫大B细胞淋巴病自体移植后复查	弥漫大B细胞淋巴瘤##自体造血干细胞移植状态	2
甲亢并双侧甲状腺肿物	甲状腺功能亢进症##甲状腺肿物	2
右肺下叶鳞癌可能	右肺下叶恶性肿瘤##鳞状细胞癌	2
颅内病变所致的偏身无力萎缩	偏侧肢体无力##肌肉萎缩	2
右腕蜂蜇伤	腕部损伤##蜂螫伤	2
腹痛-胃肠功能紊乱	腹痛##胃肠功能紊乱	2
结肠癌晚期	结肠恶性肿瘤##癌	2
四肢火焰烧伤	上肢烧伤##下肢烧伤	2
返流食管炎消化性溃疡	反流性食管炎##消化性溃疡	2
脑动脉痉挛，脑功能失调；睡眠障碍	脑动脉痉挛##睡眠障碍	2
绝经期女性严重骨质疏松伴骨痛	绝经后骨质疏松##骨痛	2
待查类风湿强脊炎	强直性脊柱炎##类风湿性关节炎	2
阴道残端鳞癌	阴道恶性肿瘤##鳞状细胞癌	2
原发不孕双侧输卵管通畅	原发不孕##输卵管术后	2
下咽癌	下咽恶性肿瘤##癌	2
空肠旋转不良并空肠异位胰腺	先天性肠旋转不良##空肠异位胰腺	2
胰腺导管内粘液样瘤	粘液瘤##胰腺良性肿瘤	2
壶腹腺癌	法特壶腹恶性肿瘤##腺癌	2
左膝股骨近端骨梗死髌股关节软骨退变	单侧膝关节骨性关节病##骨坏死	2
粒细胞缺乏伴上呼吸道感染	粒细胞缺乏##上呼吸道感染	2
膝关节骨关节炎疼痛行动不便	膝骨关节病##膝关节痛	2
腰椎压缩性骨折(骨水泥术后)	腰椎压缩性骨折##腰椎术后	2
右侧眼睑挫裂伤	眼睑挫伤##眼睑裂伤	2
哺乳期右乳头糜烂paget'病	乳腺皮肤恶性肿瘤##乳房佩吉特病	2
双膝骨性关节炎，右侧网球肘	膝骨关节病##肱骨外上髁炎[网球肘]	2
食管胃结合部腺癌	食管胃连接部恶性肿瘤##腺癌	2
双膝外侧盘状半月板轻度OA骨代谢异常	先天性盘状半月板##膝骨关节病	2
乳癌晚期	乳腺恶性肿瘤##癌	2
中度缺锌铅明显增高抵抗差多汗	锌缺乏##铅中毒	2
口腔鳞癌	口腔恶性肿瘤##鳞状细胞癌	2
右下唇鳞癌	下唇恶性肿瘤##鳞状细胞癌	2
脂溢性皮炎并脱发	脂溢性皮炎##脱发	2
荨麻疹伴感染	荨麻疹##感染	2
食指固有神经血管挫裂缺损	血管断裂##神经断裂	2
B淋巴细胞淋巴组织增生性病	淋巴细胞增殖性疾病##淋巴组织增生	2
晚孕胆瘀GDMA2	妊娠期肝内胆汁淤积症##妊娠期糖尿病	2
结肠梗阴小肠功能缺失完全不能进食	结肠梗阻##肠功能紊乱	2
甲状旁腺腺瘤	甲状旁腺良性肿瘤##腺瘤	2
结节性甲状腺肿伴囊性变	结节性甲状腺肿##囊性甲状腺肿	2
纵隔鳞状细胞癌	纵隔恶性肿瘤##鳞状细胞癌	2
慢支炎，肺气肿	慢性支气管炎##肺气肿	2
双卵巢高级别乳头状腺癌	卵巢恶性肿瘤##乳头状腺癌	2
原发性右肝癌	肝恶性肿瘤##癌	2
右手背手掌皮肤撕脱并缺损	手部开放性损伤##皮肤缺损	2
肛旁疖肿	肛门旁皮下脓肿##皮肤疖肿	2
右颈部低分化癌	颈部恶性肿瘤##癌	2
慢性肾脏病矿物质和骨代谢异常	慢性肾病##矿物质代谢紊乱	2
脊髓空洞伴不全瘫	不完全性瘫痪##脊髓空洞症	2
右侧睾丸胚胎癌	睾丸恶性肿瘤##胚胎性癌	2
双侧乳腺增生并结节形成	乳腺增生##乳房结节	2
双侧乳腺增生伴双乳囊肿	乳腺增生##乳腺囊肿	2
B族链球菌感染(直肠)	链球菌感染##未特指的细菌性肠道感染	2
汽车排气管烫伤2%Ⅲ°右前臂腹部左	上肢烫伤##躯干部烫伤	2
慢性阻塞性肺部疾病急性发作期肺心病	慢性阻塞性肺疾病急性加重##肺源性心脏病	2
特发性斑疹毛细血管扩张	毛细血管扩张症##皮疹	2
抽搐查因继发性癫痫	抽搐状态##症状性癫痫[继发性癫痫]	2
左锁骨骨折术后	锁骨骨折##骨折术后	2
左侧额窦筛窦新生物	额窦息肉##筛窦息肉	2
肺炎并肺不张	肺不张##肺炎	2
1.左内外踝骨折	内踝骨折##外踝骨折	2
双下肢溃疡伴感染	下肢溃疡##下肢软组织感染	2
呼碱合并代酸	呼吸性碱中毒##代谢性酸中毒	2
冠心病急性非ST段抬高型心肌梗死	急性非ST段抬高型心肌梗死##冠状动脉粥样硬化性心脏病	2
右肺鳞癌Ⅲ期	右肺恶性肿瘤##鳞状细胞癌	2
血铅高钙不足	低钙血症##铅中毒	2
色素性扁平苔藓灰皮病	扁平苔癣##灰色皮肤病	2
左手拇指电锯割伤伸指拇长伸肌腱断裂	拇指开放性损伤##手部肌肉肌腱断裂	2
冠心病心功能不全心律失常	冠心病心律失常型##心功能不全	2
右鼻腔新生物Ca	鼻腔恶性肿瘤##癌	2
结缔组织相关性间质性肺病	结缔组织病##间质性肺病	2
发热贫血	发热##贫血	2
免疫功能低先心病卵圆孔未闭	先天性心脏病##卵圆孔未闭	2
卵巢交界癌	卵巢交界性肿瘤##癌	2
骨髓移植术后造血干细胞移植术后	骨髓移植术后##造血干细胞移植状态	2
颈椎病;颈椎小关节紊乱;眩晕	颈椎病##颈椎小关节紊乱	2
左踝关节前方滑膜撞击征左足副舟骨	踝关节撞击综合征##先天性足副舟骨	2
左侧颈内动脉窦部动脉夹层伴眼段闭塞	颈内动脉夹层##颈内动脉闭塞	2
左眼视网膜剥离术后	视网膜脱离##眼术后	2
口腔血管瘤	口腔血管瘤##血管瘤	2
胃癌不除外	胃恶性肿瘤##癌	2
多发子宫平滑肌瘤	子宫多发性平滑肌瘤##子宫平滑肌瘤	2
左髌骨骨折术后	髌骨骨折##骨折术后	2
颈动脉硬化狭窄	颈动脉硬化##颈动脉狭窄	2
子宫颈癌IIB	子宫颈恶性肿瘤##癌	2
特指胎盘疾病胎膜残留	其他的胎盘疾患##胎盘部分残留不伴出血	2
右乳腺导管内乳头状肿瘤	乳腺良性肿瘤##导管内乳头状瘤	2
肾功轻度异常浮肿	水肿##肾功能异常	2
进展期胃癌IV期	胃恶性肿瘤##癌	2
下颌骨成釉细胞瘤术后	成釉细胞瘤##下颌骨良性肿瘤	2
右手中指血管球瘤	肢端血管瘤##血管球瘤	2
前列腺腺泡癌	前列腺恶性肿瘤##腺泡癌	2
内膜异位肌腺症	子宫内膜异位##子宫肌腺症	2
窦性心律不齐窦房结内游走心律伴不齐	窦性心律失常##窦房结游走性心律	2
左乳腺导管内乳头状肿瘤	乳腺良性肿瘤##导管内乳头状瘤	2
卵圆孔未闭或小房间缺损	卵圆孔未闭##房间隔缺损	2
颅内及颈部动脉多发斑块及狭窄	动脉狭窄##颈动脉狭窄	2
双侧额顶叶白质缺血脱髓鞘改变	脱髓鞘性白质脑病##脑血管供血不足	2
左足趾肉芽肿性炎	趾感染##肉芽肿	2
左肩背部肿瘤	肩部肿瘤##背部肿瘤	2
盆底功能障碍性疾病阴道前壁膨出I期	阴道脱垂##盆底功能障碍	2
乳腺恶性肿瘤的支持治疗	乳腺恶性肿瘤##恶性肿瘤支持治疗	2
右侧骶髂关节椎体退行性变	骨关节病##脊椎退行性病变	2
神经症右下肺间质性损害	神经症性障碍##间质性肺病	2
双侧胫骨应力性损伤	胫骨骨折##应力性骨折	2
卵巢低分化浆液性癌	卵巢恶性肿瘤##浆液性癌	2
右下肢浮肿待查淋巴回流障碍可能	淋巴回流障碍##下肢水肿	2
右肾囊性肾透明细胞癌	肾恶性肿瘤##透明细胞癌	2
原发性支气管肺癌(右肺鳞癌，rT1cN2M1c(脑)，IVB期，PS0分)	右肺恶性肿瘤##鳞状细胞癌	2
右臀部及右侧骶髂关节病变原因结核性	骶髂关节结核##臀部结核	2
右下肺鳞癌	右肺下叶恶性肿瘤##鳞状细胞癌	2
高血脂心脏损害	未特指的心脏病##高脂血症	2
慢性萎缩性胃炎伴肠化	慢性萎缩性胃炎##肠上皮化生	2
心律不齐快速型房颤	心律失常##心房颤动[心房纤颤]	2
孕34+4周孕1产0左枕；羊水过少？	孕34周##羊水过少	2
双上肢抖动原因1帕金森综合症其它	不自主运动##帕金森综合征	2
扁桃体炎，腹泻病，支气管炎;	扁桃体炎##支气管炎	2
双肘腕软组织劳损	腕部劳损##肘部劳损	2
慢性阻塞性肺气肿	慢性阻塞性肺疾病##肺气肿	2
双侧腓胫动脉不全闭塞	胫动脉闭塞##腓动脉闭塞	2
肝脏粘液性囊性肿瘤	肝良性肿瘤##粘液性囊瘤	2
纵膈积气积血	纵隔气肿##纵隔血肿	2
孕1产0孕33W+胎膜早破	孕33周##胎膜早破	2
右眼双上转肌不全麻痹	眼上直肌麻痹##眼下斜肌麻痹	2
甲状腺双叶微小乳头状癌	甲状腺恶性肿瘤##乳头状微小癌	2
右卵巢浆液性囊腺癌	卵巢恶性肿瘤##浆液性囊腺癌	2
左拇指掌指关节撕脱性骨折	拇指骨折##手部关节骨折	2
右胸腔巨大占位并胸腔积液	胸腔积液##胸部占位	2
并发性白内障ou,玻璃体混浊ou	白内障##玻璃体混浊	2
肛管-直肠癌	肛管及直肠恶性肿瘤##癌	2
高总胆固醇血症高低密度脂蛋白胆固醇血症	高脂血症##血脂异常	2
右腮腺低分化癌	腮腺恶性肿瘤##癌	2
腰背部囊肿	腰部囊肿##背部囊肿	2
左踝副舟骨源性平足	先天性足副舟骨##扁平足	2
口腔颊黏膜舌覆扁平苔藓免疫异常	口腔扁平苔癣##舌扁平苔癣	2
右乳肿物浸润性导管癌	乳腺恶性肿瘤##浸润性导管癌	2
甲状腺未分化癌	甲状腺恶性肿瘤##未分化的癌	2
先天性颈胸椎侧弯伴不全瘫	脊柱侧弯##不完全性瘫痪	2
双膝关节骨关节炎(双膝内翻畸形)	双侧膝关节骨性关节病##后天性膝内翻	2
痛经，IUD	痛经##具有子宫内避孕装置	2
1左距腓前韧带撕裂2左跟腓韧带撕裂	踝距腓前韧带断裂##跟腓韧带断裂	2
右肺上叶鳞癌	右肺上叶恶性肿瘤##鳞状细胞癌	2
烧伤后全身瘢痕增生	多处烧伤##全身多处瘢痕	2
右卵巢浆液性腺癌	卵巢恶性肿瘤##浆液性腺癌	2
肿瘤标志物升高CEA	CEA升高##肿瘤标记物升高	2
慢性支气管炎并感染	慢性支气管炎##感染	2
脑血管病/上呼吸道感染	脑血管病##上呼吸道感染	2
肝硬化伴脾功能亢进	肝硬化##脾功能亢进	2
MODS肝肾心功能损害DIC	多脏器功能障碍综合征[MODS]##弥散性血管内凝血	2
冠心病(陈旧心梗)	陈旧性心肌梗死##冠状动脉粥样硬化性心脏病	2
脊椎转移癌	脊柱继发恶性肿瘤##转移性癌	2
原发性高血压Ⅱ级	原发性高血压##高血压2级	2
食管蕈伞型中分化鳞状细胞癌	食管恶性肿瘤##鳞状细胞癌	2
尿频伴肉眼血尿半天	尿频##血尿	2
妊娠伴有1型糖尿病	妊娠合并糖尿病##1型糖尿病	2
右足第3趾皮肤部分缺血坏死	下肢皮肤坏死##下肢供血不足	2
肺心病中重度心功能II级	肺源性心脏病##心功能Ⅱ级(NYHA分级)	2
乳糜胸腹水	乳糜胸##腹水	2
腰椎病理性压缩骨折	腰椎压缩性骨折##病理性骨折	2
（左颈部）非霍奇金淋巴瘤，B小淋巴细胞淋巴瘤	非霍奇金淋巴瘤##B细胞慢性淋巴白血病/小淋巴细胞淋巴瘤	2
口底癌	口底恶性肿瘤##癌	2
高甘油三脂高尿酸	高甘油三酯血症##高尿酸血症	2
升结肠中－高分化管状腺癌	管状腺癌##升结肠恶性肿瘤	2
肩背部软组织劳损	肩颈部劳损##背部劳损	2
骨关节病(平足症)	骨关节病##扁平足	2
右手多手指完全切断拇指示指缺失	多指完全离断##后天性单侧手指缺失	2
特指胎盘疾病组织残留	胎盘部分残留不伴出血##未特指的胎盘疾患	2
胃角中分化腺癌	胃恶性肿瘤##腺癌	2
左冠前降支心肌桥伴粥样硬化斑块	冠状动脉肌桥##冠状动脉粥样硬化	2
卵巢癌Ⅳ期	卵巢恶性肿瘤##癌	2
上感/急支	上呼吸道感染##急性支气管炎	2
右足良性骨肿瘤	骨良性肿瘤##足部良性肿瘤	2
咽旁间隙及鼻咽血管瘤术后	鼻咽血管瘤##鼻咽术后	2
双侧基底节区小腔隙灶脑白质脱髓鞘改变	脱髓鞘性白质脑病##腔隙性脑梗死	2
尿瘘术后	尿道瘘##尿道术后	2
糖尿病性周围神经病变;多发性神经炎	糖尿病性周围神经病##多发性神经病[多发性神经炎/周围神经炎]	2
后躯干药物腐蚀后皮肤破损	腐蚀伤##皮肤缺损	2
腰背部劳损	腰部劳损##背部劳损	2
关节肿大待查粘多糖病	关节肿胀##粘多糖贮积病	2
慢性心衰急性加重心功能Ⅲ级	心功能III级(NYHA分级)##慢性心力衰竭	2
狂犬疫苗后急性播散性脊髓膜炎	疫苗接种后脑脊髓炎##急性播散性脑脊髓炎	2
原发性高压3级	原发性高血压##高血压3级	2
右眉弓玻璃划伤	玻璃割伤##前额开放性损伤	2
胆囊结石取石术后	胆囊结石##胆囊术后	2
胃癌?胃镜检查，预防出血	胃恶性肿瘤##癌	2
肌肉肿物NOS(右上臂肿物)	肌肉肿物##上肢肿物	2
冠状动脉粥样硬化型心脏病心绞痛	冠状动脉粥样硬化性心脏病##心绞痛	2
右半结肠回盲部腺癌	回盲部恶性肿瘤##腺癌	2
左回旋支粥样硬化伴重度狭窄	冠状动脉粥样硬化##冠状动脉狭窄	2
小儿急性喉-支气管炎	急性支气管炎##急性喉炎	2
混合性肝细胞癌和胆管癌	肝细胞癌##胆管癌	2
翼状胬肉切除术（单眼）	翼状胬肉##眼术后	2
甲状腺机能亢进-甲状腺机能减退综合征	甲状腺功能亢进症##甲状腺功能减退	2
下颌骨多发骨折	下颌骨骨折##面骨多发性骨折	2
左乳包块，孕8月	乳房肿物##孕32周	2
双卵巢高级别浆液性腺癌	卵巢恶性肿瘤##浆液性腺癌	2
烧、烫伤(急)	烧伤##其他烫伤	2
甲状腺乳头状微癌	甲状腺恶性肿瘤##乳头状微小癌	2
颈椎间盘C23膨出并椎管C56狭窄	其他的颈椎间盘移位##颈椎管狭窄	2
副脾8低白蛋白血症	低蛋白血症##先天性副脾	2
右锁骨骨折伴肩锁关节脱位	锁骨骨折##肩锁关节脱位	2
骨髓细胞学示急性淋巴细胞白血病完全缓解	急性淋巴细胞白血病##急性淋巴细胞白血病	2
（子宫）子宫内膜样腺癌，中分化；	子宫内膜样腺癌##子宫内膜恶性肿瘤	2
膀胱移行上皮癌	膀胱恶性肿瘤##癌	2
脑白质缺血性改变右侧基底节区梗塞灶	基底节脑梗死##脑血管供血不足	2
1型糖尿病性胃肠神经病变胃轻瘫	1型糖尿病##糖尿病性胃轻瘫	2
臀先露前置血管帆状胎盘可能	前置胎盘##妊娠合并帆状胎盘	2
右肾囊肿术后	肾术后##肾囊肿	2
十二指肠球部癌	十二指肠恶性肿瘤##癌	2
右肾积水伴肾功能不全	肾积水##肾功能不全	2
原发性高血压III级	原发性高血压##高血压3级	2
鼻咽癌未控治疗后进展	鼻咽恶性肿瘤##癌	2
胸椎TBCa	胸椎结核##胸椎恶性肿瘤	2
免疫性血小板减少症伴失血性贫血	免疫性血小板减少##失血性贫血	2
右大腿刀刺伤	刀刺伤##大腿开放性损伤	2
慢性浅表性胃炎伴灶性肠上皮化生	慢性浅表性胃炎##肠上皮化生	2
右肩袖巨大缺损右肱骨头部分坏死取药	肱骨头缺血性坏死##肩袖肌腱损伤	2
躯体化障碍中度焦虑轻度抑郁	焦虑状态##抑郁状态	2
宫颈湿疣阴道湿疣	尖锐湿疣##肛门生殖器疣	2
右髌骨骨折内固定术后	髌骨骨折##骨折术后	2
宫颈浸润型低分化鳞状细胞癌	子宫颈恶性肿瘤##鳞状细胞癌	2
宫颈低分化腺癌Ⅰb1期	子宫颈恶性肿瘤##腺癌	2
肛周CA	癌##肛周肿瘤	2
HTN/蛋白尿/血肌酐升高	高血压##蛋白尿	2
黏膜组织慢性炎伴淋巴组织增生	淋巴组织增生##淋巴组织增生病	2
左颈部淋巴水囊肿	囊性淋巴管瘤##颈部肿物	2
腰3椎体缩性骨折伴骨髓受压	腰椎压缩性骨折##脊髓受压	2
喉中低分化鳞状细胞癌	喉恶性肿瘤##鳞状细胞癌	2
左小腿左足缺血坏死	下肢供血不足##足坏死	2
车祸伤，左踝、足外伤	踝部损伤##足部损伤	2
乙状结肠腺瘤伴高级别上皮内瘤变	乙状结肠良性肿瘤##腺瘤	2
左侧月骨三角骨缺血坏死	月骨缺血性坏死##骨缺血性坏死	2
肺部感染伴胸腔积液	肺部感染##胸腔积液	2
慢性肾衰竭并急性肾衰竭	慢性肾衰竭##急性肾衰竭	2
纤维结构异常增殖症左股骨近端左胫骨	股骨纤维结构不良##胫骨纤维结构不良	2
卵巢交界瘤术后复查	卵巢交界性肿瘤##卵巢术后	2
左侧泌尿系结石碎石后，腰疼待查;	泌尿系结石##腰痛	2
骨关节病右膝关节置换术后	单侧膝关节骨性关节病##人工关节术后	2
右肾透明细胞性肾细胞癌	肾恶性肿瘤##透明细胞癌	2
肺部感染-咯血	肺部感染##咯血	2
热水烫伤右下肢	沸水烫伤##下肢烫伤	2
左腮腺外耳道病变左颞骨病变左颞颌关节	外耳未特指的疾患##骨病变	2
CHB后硬化	慢性乙型病毒性肝炎##乙型肝炎肝硬化	2
双侧卵巢高级别浆液性腺癌	卵巢恶性肿瘤##浆液性腺癌	2
阴茎根部Bowen氏病	鲍恩病##阴茎恶性肿瘤	2
肾盂肾盂输尿管连接处肾盏恶性肿瘤	肾盏恶性肿瘤##肾盂输尿管连接部恶性肿瘤	2
肌酶升高待查：系统性红斑狼疮？肌炎？	系统性红斑狼疮##肌炎	2
右甲良性病变术后	未特指的甲状腺疾患##甲状腺术后	2
左甲MT术后	甲状腺恶性肿瘤##甲状腺术后	2
右胸下部肋骨处外伤后疼痛3天待查	胸部损伤##骨痛	2
胎盘疾病胎盘低置状态	其他的胎盘疾患##低置胎盘	2
主动脉瓣环升主动脉发育差	先天性主动脉弓发育不良##先天性升主动脉发育不良	2
腰椎退病侧弯	腰椎退行性病变##腰椎侧弯	2
胎儿异常三倍体	三倍体和多倍体##胎儿染色体异常	2
鼻咽左侧壁未分化型非角化性癌治疗中	鼻咽侧壁恶性肿瘤##癌	2
干燥综合征继发间质性肺病	干燥综合征[舍格伦综合征]##间质性肺病	2
早孕高PRL血症	妊娠状态##高泌乳素血症	2
全身多处犬咬伤术后	多处开放性损伤##被狗咬伤	2
多点取材仅见少量高度变性癌细胞胃壁全	胃恶性肿瘤##癌	2
前列腺增大伴小囊肿	前列腺增生##前列腺囊肿	2
双侧卵巢中分化浆液-粘液混合性乳头状腺癌	卵巢恶性肿瘤##乳头状腺癌	2
单活胎头位2外阴阴道假丝酵母菌病	妊娠合并真菌性阴道炎##妊娠合并真菌性外阴炎	2
脑血管病(头晕)	头晕##脑血管病	2
右侧髂内动脉瘤并血栓形成	髂内动脉瘤##髂内动脉血栓形成	2
双卵巢高级别浆液性腺癌IIIc期	浆液性腺癌##双侧卵巢恶性肿瘤	2
左眼眼球破裂左眼角膜破裂	眼球破裂伤##角膜裂伤	2
心功能Ⅱ--Ⅲ级killip分期	KillipII级##KillipIII级	2
宫颈CINI停经原因	子宫颈上皮瘤样病变[CIN]I级##停经	2
右肱骨外侧髁陈旧性撕脱性骨折	肱骨外髁骨折##陈旧性肱骨骨折	2
突发性耳聋特发性聋	突发性聋##特发性突聋	2
双肺尖少许肺纤维化放疗后改变	放射治疗##肺纤维化	2
右胸壁左腋下软组织肿瘤	胸壁肿瘤##腋窝肿瘤	2
子宫内膜低中分化腺癌	子宫内膜恶性肿瘤##腺癌	2
多发性脑缺血脑髓鞘病	脱髓鞘性脑病##脑血管供血不足	2
胃食管反流伴咽喉反流	胃食管反流##喉咽反流	2
左胫腓骨骨折术后	小腿骨折##骨折术后	2
右肾癌骨继发恶性肿瘤	肾恶性肿瘤##癌骨继发恶性肿瘤	2
食管髓质型低分化鳞状细胞癌	食管恶性肿瘤##鳞状细胞癌	2
卵圆孔未闭6脑后循环缺血	卵圆孔未闭##后循环缺血	2
副蛋白血症性周围神经病变	多发性神经病[多发性神经炎/周围神经炎]##单克隆丙种球蛋白血症	2
左胫腓骨纤维异样增殖症	腓骨纤维结构不良##胫骨纤维结构不良	2
周围神经炎,痛风	多发性神经病[多发性神经炎/周围神经炎]##痛风	2
宫颈高危HPV53高PRL血症	高泌乳素血症##人乳头瘤病毒感染	2
颈椎病；胸背肌筋膜炎	颈椎病##筋膜炎	2
胸腰椎退行改变	胸椎退行性病变##腰椎退行性病变	2
脊柱轻度退变双膝轻度退变	双侧膝关节骨性关节病##脊柱骨关节病	2
妊娠37+1周孕2产0LOA胎膜早破	孕37周##胎膜早破	2
多发陈旧性闹梗塞	多发性脑梗死##陈旧性脑梗死	2
右侧尿路结石术后	泌尿系结石##尿道术后	2
腹股沟淋巴结继发癌	腹股沟淋巴结继发恶性肿瘤##转移性癌	2
右乳乳腺癌	乳腺恶性肿瘤##癌	2
巧克力囊肿切除守候治疗后	卵巢巧克力样囊肿##卵巢术后	2
风心病换瓣术后	具有其他心脏瓣膜置换##风湿性心脏病	2
右下叶肺癌	右肺下叶恶性肿瘤##癌	2
肝胆管细胞癌IV期	肝内胆管癌##肝胆管细胞癌	2
脑外伤后癫痫	脑外伤后遗症##癫痫	2
胎盘前置状态并胎盘边缘剥离	前置胎盘##胎盘早期剥离	2
回盲部穿孔造瘘	人工造口状态##肠穿孔	2
右侧先髋半脱位伴OA	单侧膝关节骨性关节病##先天性单侧髋关节半脱位	2
代谢性酸中毒合并高钾血症	代谢性酸中毒##高钾血症	2
妊娠39+4周，孕2产0，GDM	孕39周##妊娠期糖尿病	2
马凡综合征伴脊柱侧弯畸形	马方综合征[Marfan综合征]##脊柱侧弯	2
A345B1234楔状缺损C7龋齿	牙齿楔状缺损##龋病	2
慢性萎缩性胃大便干燥	慢性萎缩性胃炎##便秘	2
四肢骨关节炎感染行动不便	骨关节病##感染	2
停经285周胎儿肺隔离症	妊娠状态##先天性肺隔离症	2
右上肺继发性支扩复诊继发性肺纤维化	支气管扩张症##肺纤维化	2
右肱骨外髁骨折神经损伤	肱骨外髁骨折##上肢神经损伤	2
排便困难原因待查结直肠病变不能排除	排便困难##肛门和直肠未特指的疾病	2
腺性膀胱炎术后复查	腺性膀胱炎##膀胱术后	2
右肺小细胞癌Ⅳ期	右肺恶性肿瘤##小细胞癌	2
双侧放射性肺炎并感染	放射性肺炎##肺部感染	2
大肠和小肠克罗恩病脓肿[节段性肠炎]	大肠克罗恩病##小肠克罗恩病	2
双乳腺溢液待查1乳管扩张	乳腺导管扩张症##乳头溢液	2
卵巢成熟性畸胎瘤	卵巢良性肿瘤##成熟型畸胎瘤	2
股四头肌末端病臀上皮神经卡压征	臀上皮神经卡压综合征[臀上皮神经炎]##肌病	2
热水烫伤面颈部双上肢躯干7%TBSAⅡ	沸水烫伤##上肢烫伤	2
食管胃底静脉重度曲张	胃底静脉曲张##食管静脉曲张	2
面部粟粒疹尿布疹	尿布性皮炎##粟疹	2
不孕＼阴道霉菌	未特指的女性不孕症##真菌性阴道炎	2
回盲部病变并狭窄	肠未特指的疾病##肠狭窄	2
粒缺伴发热	粒细胞缺乏##发热	2
(肋间神经痛胸膜炎)	肋间神经痛##胸膜炎	2
右大鱼际皮肤软组织裂伤伴动脉损伤	手部开放性损伤##腕和手血管损伤	2
左颈胸部占位性病变	颈部占位##胸部占位	2
贫血伴血小板减少原因待查	贫血##血小板减少	2
左頰粘膜磷Ca	鳞状细胞癌##颊粘膜恶性肿瘤	2
左腹股沟疝术后	单侧腹股沟疝##腹股沟术后	2
右侧臀部截瘫后褥疮	未特指的截瘫##压疮	2
右中下肺癌	右肺中下叶恶性肿瘤##癌	2
腰45骶1椎间盘膨出椎体高信号	腰椎间盘突出##其他特指的椎间盘移位	2
肠系膜血栓伴疼痛	疼痛##肠系膜静脉血栓形成	2
多发腔隙性脑梗死灶	多发性脑梗死##腔隙性脑梗死	2
热液烫伤左足腹部6%TBSAⅡ-Ⅲ°	足部烫伤##躯干部烫伤	2
小脑扁桃体下疝伴脊髓空洞	脊髓空洞症##小脑扁桃体下疝畸形[Arnold-Chiari综合征]	2
左臀部带状疱疹后遗神经症	带状疱疹后遗症##神经症性障碍	2
右上肢尺桡骨折	桡骨骨折##尺骨骨折	2
右腕豌豆骨撕脱性骨折并半脱位可疑	腕骨骨折##腕关节半脱位	2
急性髓细胞白血病M2型化疗后	急性粒细胞性白血病部分分化型(M2型)##化学治疗	2
鞍区肿瘤放疗后	脑恶性肿瘤##恶性肿瘤放疗	2
结肠蕈伞型中分化腺癌	结肠恶性肿瘤##腺癌	2
骨盆多发性骨质破坏待查甲旁亢骨病	骨质破坏##甲状旁腺功能亢进	2
双侧颈内动脉及椎动脉多发钙斑形成	颈内动脉斑块##椎动脉斑块	2
左迷走神经鞘膜瘤	迷走神经良性肿瘤##神经鞘膜瘤	2
十二指肠占位伴梗阻	十二指肠梗阻##肠占位	2
新生儿缺陷缺氧性脑病后遗症	新生儿缺氧缺血性脑病##缺血缺氧性脑病后遗症	2
直肠低中分化管状腺癌	直肠恶性肿瘤##管状腺癌	2
周围神经癌	周围神经和自主神经系统恶性肿瘤##癌	2
晚孕胎儿四肢低于正常	妊娠状态##胎儿肢体畸形	2
冠心病-心功能Ⅰ级	冠状动脉粥样硬化性心脏病##心功能I级(NYHA分级)	2
FD肝曲综合征	肠易激综合征##消化不良	2
非霍奇金淋巴瘤-弥漫大B细胞淋巴瘤-IV期B	非霍奇金淋巴瘤##弥漫大B细胞淋巴瘤	2
维生素不足消化功能紊乱	维生素缺乏##胃肠功能紊乱	2
子宫内膜样腺癌伴鳞状上皮分化	子宫内膜样腺癌##子宫内膜恶性肿瘤	2
卵巢低级别浆液性腺癌	卵巢恶性肿瘤##浆液性腺癌	2
宫颈炎特异阴道炎	子宫颈炎##阴道炎	2
左下肢创伤后不愈创面	开放性损伤愈合不良##下肢开放性损伤	2
右上肢疤痕挛缩粘连	瘢痕挛缩##瘢痕粘连	2
右肾萎缩并多发小囊肿	肾萎缩##肾囊肿	2
右腋下脂肪瘤	腋窝良性肿瘤##脂肪瘤	2
左骶髂骨巨细胞瘤	骨巨细胞瘤##骨盆部肿瘤	2
冠心病,心绞痛型	冠状动脉粥样硬化性心脏病##心绞痛	2
食管溃疡型中分化鳞形细胞癌	食管恶性肿瘤##鳞状细胞癌	2
左上肢跌伤待查	摔伤##上肢损伤	2
盆腔神经鞘瘤	盆腔良性肿瘤##神经鞘瘤	2
升结肠1符合管状腺瘤升结肠2管状腺瘤	升结肠良性肿瘤##管状腺瘤	2
胃食管连接处慢性炎	胃炎##食管炎	2
颈髓髓内病变伴空洞形成	脊髓空洞症##脊髓病	2
糜烂性胃炎，异位胰腺	糜烂性胃炎##胰腺异位	2
肢体无力原因格林巴利综合征	肢体无力##吉兰-巴雷综合征	2
黄疸待查;肝损害	黄疸##肝功能异常	2
左手裂伤感染?	手部损伤##手感染	2
精神病肝豆状变性	肝豆状核变性[Wilson病]##精神障碍	2
两侧乳腺增生结节	乳腺增生##乳房结节	2
过敏性鼻咽炎	咽炎##过敏反应	2
左小腿肿痛待查	下肢肿胀##下肢疼痛	2
呼吸道感染胸闷;佝偻病	呼吸道感染##胸闷	2
乙状结肠管状腺瘤伴低度上皮内瘤变	管状腺瘤##乙状结肠良性肿瘤	2
双肾盂输尿管上段积液	输尿管积水##肾积水	2
子宫腔息肉型恶性中胚叶混合瘤	子宫恶性肿瘤##中胚层混合瘤	2
胰腺中分化腺癌IV期	胰腺恶性肿瘤##腺癌	2
颈椎腰椎间盘膨出症	腰椎间盘移位##其他的颈椎间盘移位	2
冠心病冠脉支架置入术后	冠状动脉粥样硬化性心脏病##冠状动脉支架植入术后状态	2
子宫颈病变CIN--IIHPV感染	宫颈上皮瘤样病变[CIN]II级##人乳头瘤病毒感染	2
肠梗阻-便秘？	肠梗阻##便秘	2
静脉曲张下肢水肿	下肢静脉曲张##下肢水肿	2
舌癌(岩)	舌恶性肿瘤##癌	2
左面神经疾患左面神经功能亢进	未特指的面神经疾患##面神经功能障碍	2
右上肺斑片状影陈旧性病灶	肺病##肺部阴影	2
左乙状窦横窦狭窄颅内多发腔隙性梗死	腔隙性脑梗死##多发性脑梗死	2
肺中分化腺癌	肺恶性肿瘤##腺癌	2
胃癌(伴转移)	胃恶性肿瘤##癌	2
筛窦癌化疗	筛窦恶性肿瘤##癌	2
高热惊厥可能4卵圆孔未闭	热性惊厥##卵圆孔未闭	2
结肠中-低分化腺癌	结肠恶性肿瘤##腺癌	2
食管中分化鳞形细胞癌	食管恶性肿瘤##鳞状细胞癌	2
膀胱非浸润性乳头状尿路上皮癌	膀胱恶性肿瘤##非侵袭性乳头状尿路上皮癌	2
胆汁反流性胃炎	反流性胃炎##胆汁反流	2
弥漫性实质性肺疾病特发性间质性肺纤维化	弥漫性肺间质疾病##特发性肺间质纤维化	2
皮肤异色病样扁平苔藓LE	扁平苔癣##红斑狼疮	2
双侧胫前及右侧胫后动脉慢性闭塞型改变	胫后动脉闭塞##胫前动脉闭塞	2
发作性头昏原因待查脑血管功能紊乱	头晕##脑血管病	2
右手示中环指玻璃划伤	手指开放性损伤##玻璃割伤	2
左手拇指开放性脱位	拇指关节脱位##拇指开放性损伤	2
哮喘,缺锌	支气管哮喘##锌缺乏	2
右胸壁脂肪坏死性肉芽肿性炎	脂肪坏死##肉芽肿	2
头面部瘀伤	面部损伤##头部损伤	2
右附件囊性病变-输卵管结积液可能	输卵管卵巢囊肿##右侧输卵管积水	2
埋伏牙和阻生牙	埋伏牙##阻生牙	2
卵巢恶性肿瘤伴腹水	卵巢恶性肿瘤##腹水	2
癫痫周围神经病	癫痫##多发性神经病[多发性神经炎/周围神经炎]	2
口腔舌尖扁平苔藓	口腔扁平苔癣##舌扁平苔癣	2
膀胱癌(高级别尿路上皮癌)	尿路上皮癌##膀胱恶性肿瘤	2
左肘疤痕挛缩伴功能受限	瘢痕挛缩##肘部瘢痕	2
食管溃疡型鳞癌	食管恶性肿瘤##鳞状细胞癌	2
左踝部蜂蜇伤	蜂螫伤##踝部损伤	2
缺铁低骨密度	铁缺乏##骨密度和结构疾患	2
左房左室肥大左室舒张功能减退	心房肥大##心室肥大	2
脑动静脉畸形栓塞术后	脑动静脉畸形##动静脉畸形栓塞术后	2
右肺斑片影陈旧性病变可能性大	肺病##肺部阴影	2
幽门管管状腺瘤	胃良性肿瘤##管状腺瘤	2
右手小指外伤清创术后	手指开放性损伤##清创术后	2
双下肢犬伤	下肢开放性损伤##被狗咬伤	2
肺部纤维灶右上肺斑片影	肺部阴影##肺诊断性影像异常	2
右侧眶颧骨折	眶骨骨折##颧骨骨折	2
右颈神经鞘瘤	颈部周围神经和自主神经良性肿瘤##神经鞘瘤	2
颈部恶性神经鞘瘤术后	颈部恶性肿瘤##恶性神经鞘瘤	2
贲门早Ca	贲门恶性肿瘤##癌	2
共同性外斜视(术后)	眼术后##共同性内斜视	2
胃食管结合部中重度异型增生	食管粘膜不典型增生##胃粘膜不典型增生	2
隐匿性精子症染色体核型异常遗传性	未特指的染色体异常##隐匿性无精子症	2
右侧输卵管伞端闭锁并积血	输卵管血肿##输卵管闭锁	2
双眼闭角型青光眼（右眼抗青术后，左眼临床前期）	闭角型青光眼##眼术后	2
淤积性湿疹并感染	湿疹##感染	2
言语不能右肢无力待查	言语障碍##偏侧肢体无力	2
鞍区占位病变垂体腺瘤	脑占位性病变##垂体腺瘤	2
腹部左大腿打伤	腹部损伤##大腿损伤	2
食管低分化鳞状细胞癌	食管恶性肿瘤##鳞状细胞癌	2
直肠中低分化管状腺癌	直肠恶性肿瘤##管状腺癌	2
卵巢中低分化腺癌	卵巢恶性肿瘤##腺癌	2
下咽部差分化腺癌	咽恶性肿瘤##腺癌	2
白细胞疾患白细胞低	白细胞减少##未特指的白细胞疾患	2
颈腰椎病	颈椎病##腰椎病	2
腹腔镜保胆取石术后	胆囊术后##胆石症	2
左乳导管扩张伴导管囊肿	乳腺导管扩张症##乳腺囊肿	2
腺瘤甲状腺	甲状腺良性肿瘤##腺瘤	2
学习困难.铅高	学习技能发育障碍##铅中毒	2
龈口炎	龈炎##口炎	2
髂腰肌囊性占位	髂肌囊肿##腰部囊肿	2
汗腺孔癌	汗腺恶性肿瘤##癌	2
预计综合症射频消融	预激综合征[沃-帕-怀综合征]##射频消融术后	2
隐匿性抑郁慢性主观性头昏	抑郁状态##头晕	2
上肢恶性黑色素瘤	上肢恶性黑色素瘤##恶性黑色素瘤	2
手裂伤伴感染	手部开放性损伤##感染	2
外阴Paget病局部早侵	乳房以外的佩吉特病##外阴恶性肿瘤	2
双下肢胫前动脉闭塞双下肢胫后动脉闭塞	胫前动脉闭塞##胫后动脉闭塞	2
良性前列腺增生术后	前列腺增生##前列腺术后	2
急性坏疽穿孔性阑尾炎伴腹膜炎	急性坏疽性阑尾炎伴穿孔##急性坏疽性阑尾炎伴腹膜炎	2
4%烫伤额面部左胸部左上肢浅II度	上肢烫伤##躯干部烫伤	2
冠心脏心肌缺血	冠状动脉粥样硬化性心脏病##心肌供血不足	2
左侧颈动脉岩段动脉夹层伴重度狭窄	颈动脉夹层##颈动脉狭窄	2
腰椎压缩性骨折L3	腰椎压缩性骨折##腰椎骨折L3	2
右大腿滑膜肉瘤	滑膜肉瘤##下肢恶性肿瘤	2
胆总管末端粘液腺癌	胆总管恶性肿瘤##腺癌	2
开放性特重型颅脑外伤性意识障碍	头部损伤##意识障碍	2
腹膜后及腹腔内多发稍大淋巴结	腹腔淋巴结肿大##腹膜后淋巴结肿大	2
左肾切开取石术后	肾结石##肾术后	2
左背部玻璃割伤	背部开放性损伤##玻璃割伤	2
肝门区胆管癌	肝门胆管恶性肿瘤##癌	2
全身多关节肿痛	关节肿胀##关节痛	2
左腹膜后淋巴结转移癌	腹膜后淋巴结继发恶性肿瘤##转移性癌	2
左下肢梭形细胞恶性肿瘤	下肢恶性肿瘤##梭形细胞型恶性肿瘤	2
冠心病--心功能不全	冠状动脉粥样硬化性心脏病##心功能不全	2
LN复查手裂口化脓	狼疮性肾炎##手部开放性损伤	2
阴囊炎性破溃	阴囊炎##阴囊开放性损伤	2
直肠中低分化腺癌	直肠恶性肿瘤##腺癌	2
右肾积水伴右输尿管扩张	肾积水##输尿管扩张	2
肝肝细胞异型增生胆管增生	肝细胞不典型增生##胆道不典型增生	2
头昏胀高TC	头晕##高胆固醇血症	2
妊娠性瘙痒症	瘙痒症##妊娠状态	2
HL经典型结节硬化型IIB期化疗后	结节硬化型经典霍奇金淋巴瘤##化学治疗	2
右肺下叶小细胞癌广泛期	右肺下叶恶性肿瘤##小细胞癌	2
左胫前远端恶性黑素瘤T4N0M0IIC期	下肢恶性黑色素瘤##恶性黑色素瘤	2
乳腺肿瘤(化疗后)	乳腺恶性肿瘤##化学治疗	2
周围神经病变--酒精性周围神经病变可能	多发性神经病[多发性神经炎/周围神经炎]##酒精中毒性周围神经病	2
左股骨腓骨骨质改变骨纤维结构不良	腓骨纤维结构不良##股骨纤维结构不良	2
右胸腹部外伤	胸部损伤##腹部损伤	2
4、右胫骨中段骨折术后骨愈合	胫骨骨折##骨折术后	2
原发性腹膜癌IIIC期	腹膜恶性肿瘤##癌	2
肝脏肾上腺占位	肝占位性病变##肾上腺占位	2
抑郁伴躯体功能障碍	抑郁状态##躯体性机能障碍	2
脑动脉硬化脂肪肝	动脉硬化##脂肪肝	2
左外耳道闭锁左耳腮裂瘘管	鳃裂瘘##先天性外耳道闭锁	2
右腕部尺神经瘤	神经瘤##尺神经良性肿瘤	2
左乳腺肿物伴感染	乳房肿物##感染	2
多饮多尿待查	多尿##多饮	2
意识不清待查肝脑可能性大	肝性脑病##意识障碍	2
食管胃交界溃疡型混合型神经内分	食管胃连接部恶性肿瘤##神经内分泌癌	2
前次手术后子宫瘢痕	子宫术后##瘢痕子宫	2
左肩胸部梭形细胞瘤	胸部肿瘤##肩部肿瘤	2
原发不孕子宫不全纵膈	原发不孕##子宫不全纵隔	2
鼻炎、腺样体肥大？;	鼻炎##腺样体肥大	2
腹痛待查、原发性高血压2级高危	腹痛##原发性高血压	2
盲肠腺瘤	盲肠良性肿瘤##腺瘤	2
原发巨大肝癌。	肝恶性肿瘤##癌	2
左前臂皮肤划伤清创缝合后	前臂开放性损伤##清创术后	2
宫内膜复杂性增生局部轻度非典型性	子宫内膜增生##宫颈上皮不典型增生	2
恶心纳差待查	恶心##食欲不振	2
双肺间质性改变特发性肺纤维化可能性大	间质性肺病##肺纤维化	2
喉部新生物Ⅱ度呼吸不畅	喉息肉##呼吸困难	2
产后胎盘残留胎盘置入	胎盘部分残留不伴出血##胎盘植入不伴出血	2
升结肠溃疡型中分化腺癌，大小4.2×3.5cm	升结肠恶性肿瘤##腺癌	2
头面部多处开放性损伤	头部多处开放性损伤##面部开放性损伤	2
双足膝内翻	足畸形##膝内翻	2
主动脉瓣三尖瓣中度闭锁不全	主动脉瓣关闭不全##三尖瓣关闭不全	2
左足反复破溃伤口不愈除外骨质改变	足部损伤##开放性损伤愈合不良	2
左乳导管上皮乳头状增生伴导管扩张	乳腺导管扩张症##乳腺增生	2
鼻咽低分化鳞癌放化疗后的随诊检查	鼻咽恶性肿瘤##鳞状细胞癌	2
右卵巢高级别浆液性癌IIA期	卵巢恶性肿瘤##浆液性癌	2
右侧甲状腺滤泡型腺瘤囊性变	甲状腺良性肿瘤##滤泡性腺瘤	2
妊娠32周5/4宫内死胎	孕32周##胎死宫内	2
2型糖尿病可能性大糖尿病酮症酸中毒	2型糖尿病##2型糖尿病性酮症酸中毒	2
重度骨质疏松(伴骨痛)	重度骨质疏松##骨痛	2
T11-L1压缩性骨折；	胸椎压缩性骨折##腰椎压缩性骨折	2
直肠结肠粘膜低级别管状及绒毛管状腺瘤	直肠良性肿瘤##管状绒毛状腺瘤	2
西医1神经症2脑后循环缺血	后循环缺血##未特指的神经症性障碍	2
右肾盂高级别尿路上皮癌	肾恶性肿瘤##尿路上皮癌	2
弥漫性脑病脑器质性功能障碍	弥散性脑病##脑病[器质性脑病]	2
细菌性阴道炎(外阴炎)	细菌性阴道炎##外阴炎	2
乙状结肠癌(PT3N2BM0 IIIC期)	乙状结肠恶性肿瘤##癌	2
右肺纤维硬结灶右肺肥大泡	肺诊断性影像异常##肺大疱	2
手足发育异常	先天性手畸形##先天性足畸形	2
化疗后血小板减低症	化疗药物反应##药物性血小板减少	2
前列腺组织内腺癌浸润	前列腺恶性肿瘤##腺癌	2
慢性主观性头昏自主神经功能不全	自主神经功能紊乱##头晕	2
腰椎间盘突出症继发椎管狭窄	腰椎间盘突出##腰椎管狭窄	2
多原发结肠癌MSI	结肠恶性肿瘤##癌	2
左膝股骨外髁大面积骨软骨剥脱伴游离体形成	膝关节骨软骨炎##膝关节游离体	2
心悸气短	心悸##气短	2
右侧三叉神经鞘瘤	神经鞘瘤##三叉神经良性肿瘤	2
肝脏挫伤术后	肝挫伤##肝术后	2
胚胎移植后宫内早孕合并宫外孕	胚胎移植术后##异位妊娠	2
右肺上叶周围型腺癌	右肺上叶恶性肿瘤##腺癌	2
脾破裂出血	脾破裂##脾出血	2
周围神经病变壶腹部十二指肠壁导管异位	多发性神经病[多发性神经炎/周围神经炎]##十二指肠异位胰腺	2
神志模糊右肢无力待查	肢体无力##意识障碍	2
直肠送检大肠粘膜呈绒毛状-管状腺瘤	直肠良性肿瘤##管状绒毛状腺瘤	2
双侧肾癌	肾恶性肿瘤##癌	2
右手不自主运动周围神经病后	多发性神经病[多发性神经炎/周围神经炎]##不自主运动	2
心肌桥前降支肌桥收缩期狭窄约85	冠状动脉肌桥##冠状动脉狭窄	2
慢性结肠炎伴肠功能紊乱	慢性结肠炎##肠功能紊乱	2
复发性弥漫大B细胞淋巴瘤	弥漫大B细胞淋巴瘤##恶性肿瘤复发	2
直肠粘液腺癌	直肠恶性肿瘤##粘液腺癌	2
十二指肠壶腹部中低分化腺癌	法特壶腹恶性肿瘤##腺癌	2
鼻咽恶性肿瘤联合治疗后的随诊检查	鼻咽恶性肿瘤##恶性肿瘤联合治疗后的随诊检查	2
胸椎腰椎病变并不全瘫	不完全性瘫痪##腰椎病	2
慢性浅表性胃炎轻度萎缩	慢性浅表性胃炎##慢性萎缩性胃炎	2
右膝部挫擦伤	膝部挫伤##膝部擦伤	2
CABG术后胸腔积水	冠状动脉搭桥术后##胸腔积液	2
HIV病毒携带者实验确认报告阳性	其他传染病病原携带者##人类免疫缺陷病毒阳性[HIV阳性]	2
面部多处软组织切割伤	面部损伤##多处切割伤	2
十二指肠降部腺瘤	十二指肠良性肿瘤##腺瘤	2
食欲缺乏心衰胃肠道淤血引起可能	食欲缺乏##心力衰竭	2
凝血障碍慢性DIC可能	凝血功能障碍##弥散性血管内凝血	2
左股骨慢性骨髓炎	股骨骨髓炎##慢性骨髓炎	2
双肺部分慢性炎症，部分炎性肉芽肿形成可能	肺炎##肺肉芽肿	2
腰椎轻度侧弯伴腰45轻度不稳	腰椎侧弯##腰椎不稳定	2
结核性脊柱弯曲波特氏弯曲	结核感染##脊柱畸形	2
神经系统特指疾患发作性肢体无力待查	神经系统病变##肢体无力	2
胸部枪击伤	胸部开放性损伤##枪击伤	2
乳房纤维腺瘤	乳腺良性肿瘤##纤维腺瘤	2
双肩颈部肿痛	颈部肿胀##躯干肿胀	2
肝切除射频治疗后	肝术后##恶性肿瘤射频治疗	2
右侧耳后伤口愈合不良	开放性损伤愈合不良##耳部开放性损伤	2
先天性心脏病术后（室间隔缺损）	先天性心脏病术后##室间隔缺损	2
(降结肠)腺瘤性息肉	降结肠息肉##腺瘤样息肉	2
喉咽癌综合治疗后	喉咽恶性肿瘤##癌	2
双眼浮肿过敏性疾病	眼睑水肿##过敏反应	2
右下肢神经、血管损伤	身体未特指部位的神经损伤##身体未特指部位的血管损伤	2
癫痫脑梗死	癫痫##脑梗死	2
脑垂体肿瘤放疗后	垂体恶性肿瘤##恶性肿瘤放疗	2
反应差待查：肺炎呼衰	肺炎##呼吸衰竭	2
黏多糖贮积症Ⅰ型双侧髋关节病理性脱	粘多糖贮积病I型[Hurler综合征]##髋关节脱位	2
脑白质缺血性病变老年性脑改变	脑白质病##脑血管供血不足	2
高血压病(左房大)	高血压##左房扩大	2
肾实质萎缩囊性变肾皮质部分肾小球玻璃	肾囊肿##肾萎缩	2
双拇趾外翻右肘关节OA	肘骨关节病##足拇外翻	2
黄斑变性注药术后	黄斑变性##眼术后	2
椎体压缩骨折术后	脊柱骨折##骨折术后	2
结肠肝曲管状腺瘤局部上皮中度不典型	结肠肝曲良性肿瘤##管状腺瘤	2
子宫肌瘤并腺肌症	子宫肌腺症##子宫平滑肌瘤	2
眼视神经瘤	神经瘤##视神经良性肿瘤	2
卵巢成熟性囊性畸胎瘤伴神经胶质成分	卵巢良性肿瘤##成熟型囊性畸胎瘤	2
梗阻性黄疸PTCD及胆道支架置入术后	梗阻性黄疸##胆管支架置入术后	2
右足皮肤撕脱伴坏死	足部软组织撕脱伤##足坏死	2
肩背部脂肪增生症	肩部脂肪增多症##背部脂肪增多症	2
泌乳素瘤	垂体泌乳素瘤##垂体良性肿瘤	2
（右肺上叶）中分化鳞状细胞癌PT1N0M0Ia期	右肺上叶恶性肿瘤##鳞状细胞癌	2
颈部软组织感染合并淋巴结炎	颈部软组织感染##颈淋巴结炎	2
桡骨骨折术后	桡骨骨折##骨折术后	2
左肺上叶下舌段细支气管扩张并少许纤维灶	支气管扩张症##肺诊断性影像异常	2
头颈部皮下肿物	头部肿物##颈部肿物	2
乙状结肠腺癌	乙状结肠恶性肿瘤##腺癌	2
左鼻空疤痕挛缩狭窄	瘢痕挛缩##鼻部瘢痕	2
右上肺鳞状细胞癌介入治疗后	右肺上叶恶性肿瘤##鳞状细胞癌	2
高血压(眩晕-肝肾不足)	高血压##眩晕	2
双侧颈部及颅内动脉多发斑块及狭窄	动脉狭窄##颈动脉狭窄	2
鼻咽非角化癌	鼻咽恶性肿瘤##癌	2
右肾结节查因:错构瘤	肾错构瘤##肾占位性病变	2
胃底胃体癌综合治疗后	胃底及胃体恶性肿瘤##癌	2
直肠绒毛管状腺瘤不除外有更严重病变可能	直肠良性肿瘤##管状绒毛状腺瘤	2
肛管癌	肛管恶性肿瘤##癌	2
右侧肢体发僵流涎待查	流涎症##肢体僵硬	2
头晕胀痛	头晕##头痛	2
肺肿瘤,恶性(术后)	肺恶性肿瘤##肺术后	2
多发缺血性白质脱髓鞘改变	脱髓鞘性白质脑病##脑血管供血不足	2
胃角早期胃癌	胃恶性肿瘤##癌	2
咽壁恶性肿瘤	咽壁恶性肿瘤##咽炎	2
摔伤头部	头部损伤##摔伤	2
甲状腺肿物切除	甲状腺肿物##甲状腺术后	2
癌术后靶向治疗	恶性肿瘤术后靶向治疗##癌	2
十二指肠腺瘤	十二指肠良性肿瘤##腺瘤	2
左足副舟骨源性平足症	先天性足副舟骨##扁平足	2
视网膜病(术后)	视网膜病##眼术后	2
横结肠绒毛状管状腺瘤伴高度粘	横结肠良性肿瘤##管状绒毛状腺瘤	2
腹主动脉扩张伴硬化	腹主动脉硬化##腹主动脉扩张	2
肱骨恶性肿瘤(骨肉瘤)	肱骨恶性肿瘤##骨肉瘤	2
左足第2趾远节趾骨骨折，左足第2趾软组织缺损	足部损伤##趾骨骨折	2
近肝曲横结肠绒毛管状腺瘤伴中度异型增生	横结肠良性肿瘤##管状绒毛状腺瘤	2
尺神经病变颈腰椎病取药	颈椎病##腰椎病	2
腰背筋膜劳损	腰部劳损##背部劳损	2
宫颈子宫内膜样腺癌	子宫内膜恶性肿瘤##腺癌	2
右侧卵巢成熟性囊性畸胎瘤	成熟型囊性畸胎瘤##卵巢良性肿瘤	2
肩关节恶性肿瘤，左，滑膜肉瘤，术后	肩关节恶性肿瘤##滑膜肉瘤	2
甲状腺双叶占位肥胖	肥胖##甲状腺占位	2
孕21周1天LMP:2014.09.08。13/01TSH：2.667	孕21周##面先露	2
头昏沉原因癔症样发作	头晕##癔症样发作	2
右侧肺炎伴肺炎旁胸腔积液	肺炎##胸腔积液	2
早孕人流宫颈HPV58	早期人工流产##宫颈人乳头瘤病毒感染	2
膝关节骨关节炎左膝游离体	单侧膝关节骨性关节病##膝关节游离体	2
右侧乳腺癌pT2N2M0	乳腺恶性肿瘤##癌	2
高血压血糖增高	高血压##血糖升高	2
阴道恶性黑色素瘤	阴道恶性肿瘤##恶性黑色素瘤	2
肾移植术后,肺部感染	肾移植状态##肺部感染	2
内侧指神经血管断裂	血管断裂##神经断裂	2
颈腰部疼痛待查	颈痛##腰痛	2
放射性口腔炎	口炎##放射性损害	2
23埋伏阻生	埋伏牙##阻生牙	2
双肺胸膜下微小结节	肺占位性病变##胸膜占位	2
唐氏综合症先心病	21-三体综合征[Down综合征]##先天性心脏病	2
右膝关节外侧盘状盘状半月板伴Ⅲ°撕裂	先天性盘状半月板##膝外侧半月板撕裂	2
双卵巢粘液性低分化腺癌	卵巢恶性肿瘤##腺癌	2
左股骨骨折术后	股骨骨折##骨折术后	2
上感-发热	上呼吸道感染##发热	2
早孕阴道真菌	妊娠状态##真菌性阴道炎	2
盆腔癌	盆腔恶性肿瘤##癌	2
妊娠期糖尿病G4P1孕39+4周待产LOA	妊娠期糖尿病##孕39周	2
左拇指掌指关节半脱位虎口挛缩	掌指关节脱位##拇指关节脱位	2
左胫骨中下段骨折术后	胫骨骨折##骨折术后	2
癌化学治疗后的随诊检查	癌##恶性肿瘤放射治疗后的随诊检查	2
左侧输尿管切开取石术后	输尿管结石##输尿管术后	2
特指大便异常原因待查未除肠道病变	其他大便异常##肠未特指的疾病	2
耳特指疾患双耳听力障碍	听功能障碍##耳其他特指的疾患	2
股四头肌腱及髌韧带部分撕裂	髌韧带损伤##股四头肌肌腱损伤	2
(肺刀刺伤)	肺的其他损伤##刀刺伤	2
感染性疾病结缔组织疾病血液系统疾病	结缔组织病##血液和造血器官未特指的疾病	2
腰1椎体后缩性骨折	腰椎骨折L1##腰椎压缩性骨折	2
梨状窝鳞状细胞癌	梨状窝恶性肿瘤##鳞状细胞癌	2
横结肠管状腺瘤伴低级别上皮内瘤变	横结肠良性肿瘤##管状腺瘤	2
前列腺癌近距离治疗术后	前列腺恶性肿瘤##癌	2
贲门腺癌	贲门恶性肿瘤##腺癌	2
肝硬化\便血	肝硬化##便血	2
哮喘，植物神经功能紊乱	支气管哮喘##植物神经功能紊乱	2
右胫腓骨远端粉碎性开放性骨折伴感染	胫骨远端骨折伴腓骨骨折##感染	2
中分化腺癌伴粘液腺癌	腺癌##粘液腺癌	2
甲状腺滤泡性腺瘤伴囊性变	甲状腺良性肿瘤##滤泡性腺瘤	2
双卵巢低中分化腺癌	卵巢恶性肿瘤##腺癌	2
膀胱微乳头型尿路上皮癌	膀胱恶性肿瘤##乳头状尿路上皮癌	2
颅内多发脑缺血脑白质脱髓鞘改变	脱髓鞘性白质脑病##脑血管供血不足	2
鼻咽未分化非角化癌T2N2M0	鼻咽恶性肿瘤##未分化的癌	2
骨盆尤文氏肉瘤	尤因肉瘤##骨盆部肿瘤	2
右肱骨外科颈骨折伴大结节撕脱	肱骨外科颈骨折##肱骨大结节骨折	2
多发脑白质病变缺血性可能	脑白质病##脑血管供血不足	2
骶尾部皮肤软组织广泛撕脱伴缺损	躯干开放性损伤##皮肤缺损	2
左眼人工晶体眼左眼晶体皮质残留	玻璃体内晶状体皮质残留##人工晶体植入状态	2
右侧桡骨远端开放性骨折	桡骨远端骨折##上肢开放性骨折	2
粘连性不全性肠梗	不完全性肠梗阻##粘连性肠梗阻	2
右手掌疤痕组织挛缩伴肌腱粘连	瘢痕挛缩##瘢痕性肌腱粘连	2
左膝关节局灶性骨梗死退变	单侧膝关节骨性关节病##骨坏死	2
左颞骨面神经瘤	神经瘤##面神经良性肿瘤	2
颈部粉瘤感染	颈部皮脂腺囊肿##感染	2
孕31周贫血	孕31周##妊娠合并贫血	2
副乳癌	副乳腺恶性肿瘤##癌	2
认知功能减退原因待查副肿瘤综合征	认知障碍##副肿瘤综合征	2
粘液腺癌伴印戒细胞癌	粘液腺癌##印戒细胞癌	2
肺炎在感染	肺炎##肺部感染	2
胃低分化腺癌	胃恶性肿瘤##腺癌	2
高血压肾病便秘	高血压性肾病##便秘	2
腰椎间盘突出症高`血压	腰椎间盘突出##高血压	2
先天被动免疫性血小板减少症	先天性血小板减少##免疫性血小板减少	2
右颈部纤维脂肪病	颈部良性肿瘤##纤维脂肪瘤	2
胸椎骨折伴脊髓损害	胸椎骨折##胸部脊髓损伤	2
双侧颈总动脉分叉处混斑中度狭窄	颈总动脉狭窄##颈总动脉斑块	2
面颈部刀伤	面部开放性损伤##颈部开放性损伤	2
甲状腺功能减低Turner综合症	甲状腺功能减退##特纳综合征[Turner综合征]	2
营养性混合性贫血	营养性贫血##混合性贫血	2
左胫腓骨骨折	腓骨骨折##胫骨骨折	2
先天性心脏病法洛四联症	先天性心脏病##法洛四联症	2
血凝系统功能异常弥漫性血管内凝血可能	凝血功能异常##弥散性血管内凝血	2
子宫肌间型平滑肌瘤	子宫平滑肌瘤##子宫平滑肌瘤	2
肺上叶支气管恶性肿瘤	支气管恶性肿瘤##肺上叶恶性肿瘤	2
双侧豆状核变性萎缩	大脑变性##脑萎缩	2
紫外线灼伤躯干	紫外线辐射引起烧伤##躯干未特指的损伤,水平未特指	2
左上纵隔癌结合形态及免疫表型考虑	纵隔恶性肿瘤##癌	2
面颈部皮肤松弛	面部皮肤松弛##颈部皮肤松弛	2
先天性主动脉瓣畸形并中-重度关闭不全	先天性主动脉瓣畸形##先天性主动脉瓣关闭不全	2
胆囊及胆总管结石	胆囊结石##胆总管结石	2
系统性硬皮病相关肺间质病	系统性硬化症##间质性肺病	2
胫骨平台骨折术后	胫骨平台骨折##骨折术后	2
皮肤鳞状细胞癌术后	皮肤恶性肿瘤##鳞状细胞癌	2
子宫内膜粘液腺癌	子宫内膜恶性肿瘤##粘液腺癌	2
贲门粘液腺癌	贲门恶性肿瘤##粘液腺癌	2
G4PO孕28+W待产ROA,产前出血原因待查?胎儿位置异常	孕28周##产前出血	2
外阴鳞癌	外阴恶性肿瘤##鳞状细胞癌	2
距肛门55cm结肠管状腺瘤Ⅱ级	结肠良性肿瘤##管状腺瘤	2
胃炎、胃息肉？	胃炎##胃息肉	2
右胫腓骨双骨折	腓骨骨折##胫骨骨折	2
慢性阻塞性肺病伴急性加重伴双肺肺炎	慢性阻塞性肺疾病急性加重##肺炎	2
淤血性脾肿大另送副脾组织	先天性副脾##脾大	2
双肺气肿并肺大泡形成	肺气肿##肺大疱	2
鼾症伴低通气综合征	鼾症##睡眠低通气综合征	2
直肠中下段腺癌	直肠恶性肿瘤##腺癌	2
腰椎间盘膨出继发神经损害	腰椎间盘移位##腰骶神经损伤	2
唇部过敏	过敏反应##唇炎	2
脐尿管瘘并感染	先天性脐尿管瘘##感染	2
子宫内膜中分化子宫内膜样腺癌	子宫内膜样腺癌##子宫内膜恶性肿瘤	2
口咽鳞状细胞癌	鳞状细胞癌##口咽恶性肿瘤	2
支气管哮喘并肺部感染	支气管哮喘##肺部感染	2
弥漫性大细胞恶性淋巴瘤	弥漫大B细胞淋巴瘤##弥漫性大B细胞恶性淋巴瘤	2
宫颈中高分化鳞状细胞癌	子宫颈恶性肿瘤##鳞状细胞癌	2
胃幽门癌	幽门恶性肿瘤##癌	2
食管癌小细胞型	食管恶性肿瘤##癌	2
骨癌	骨恶性肿瘤##癌	2
开水烫伤全身多处	沸水烫伤##多发烫伤	2
西医1抑郁症伴焦虑2老年性脑改变	抑郁发作##焦虑状态	2
右侧胫前及胫后动脉慢性闭塞病变	胫前动脉闭塞##胫后动脉闭塞	2
肠系膜血管缺血性病变及痉挛性改变	肠系膜动脉供血不足##肠痉挛	2
右侧颞叶内侧梗塞急性期多发性腔隙性脑梗塞	多发性脑梗死##腔隙性脑梗死	2
腹腔非霍奇金淋巴瘤	腹部恶性肿瘤##非霍奇金淋巴瘤	2
胆管细胞性肝癌	肝恶性肿瘤##肝胆管细胞癌	2
听神经鞘瘤	听神经瘤##听神经良性肿瘤	2
肺癌广泛期	肺恶性肿瘤##癌	2
贫血,妊娠	贫血##妊娠状态	2
右肱骨大结节、肩胛盂骨折	肱骨大结节骨折##肩关节盂骨折	2
上颌前牙区埋伏多生牙	埋伏牙##多生牙	2
小肠恶性肿瘤(术后 透明细胞肉瘤)	小肠恶性肿瘤##透明细胞肉瘤	2
卵巢交界瘤术后复发	卵巢交界性肿瘤##卵巢术后	2
腹胀痛	腹胀##腹痛	2
左眼睑皮肤球结膜下色素沉着	皮肤色素沉着##结膜色素沉着	2
B细胞肿瘤	B细胞淋巴瘤##淋巴瘤	2
扁桃体及腺样体组织慢性炎伴淋巴组织增生	扁桃体和腺样体未特指的慢性疾病##淋巴组织增生	2
肝囊肿(术后)	肝囊肿##肝术后	2
糖尿病足截趾术后	糖尿病足##截肢	2
混合性肝细胞癌和胆管细胞癌	肝恶性肿瘤##肝胆管细胞癌	2
头部跌伤后	头部损伤##摔伤	2
先天性神经性肌强直	先天性肌强直症[Thomsen病]##神经性肌强直[艾萨克斯综合征]	2
卵巢高级别浆液性腺癌	卵巢恶性肿瘤##腺癌	2
结肠绒毛状管状腺瘤低级别直径15cm	结肠良性肿瘤##管状绒毛状腺瘤	2
1脑缺血脱髓鞘2空蝶鞍	脱髓鞘性脑病##脑血管供血不足	2
左盂肱关节破坏结核性类风湿性	类风湿性肩关节炎##肩关节结核	2
淋巴瘤复发	淋巴瘤##恶性肿瘤复发	2
处女膜破裂出血	处女膜撕裂伤##出血	2
性早熟中枢性性早熟单纯乳房发育	乳房早发育##中枢性性早熟	2
面部原位黑(色素)瘤	面恶性黑色素瘤##原位黑色素瘤	2
左大腿蜜蜂刺伤	蜂螫伤##大腿开放性损伤	2
宫颈中分化内膜样腺癌Ib1期	子宫颈恶性肿瘤##子宫内膜样腺癌	2
面部皮肤乳头状肿瘤	乳头状瘤##面部皮肤良性肿瘤	2
面双上肢灼伤10%2度	面部开放性损伤##上肢开放性损伤	2
右侧梨状窝低分化鳞状细胞放化疗后	放射治疗##化学治疗	2
右肺上叶侵润性腺癌	右肺上叶恶性肿瘤##腺癌	2
T12-L1压缩性骨折	胸椎压缩性骨折##腰椎压缩性骨折	2
右肺周围型中分化腺癌	右肺恶性肿瘤##腺癌	2
十二指肠壶腹周围癌	法特壶腹周围恶性肿瘤##癌	2
右乳上象限浸润性导管癌	乳腺恶性肿瘤##浸润性导管癌	2
消化道癌	消化道恶性肿瘤##癌	2
左肺见增生纤维胶原及真菌菌丝	肺真菌感染##肺纤维化	2
C7龋齿A8牙本质过敏	龋病##牙本质过敏症	2
胸膜膈肌钙化斑	胸膜钙化##肌肉的其他钙化	2
右侧输卵管伞端闭锁伴输卵管积液	右侧输卵管积水##输卵管闭锁	2
停经336周B超提示胎儿右侧肾脏双肾盂	妊娠状态##双肾盂	2
左舌颌下腺囊肿	下颌下腺囊肿##舌下腺囊肿	2
泌乳素型垂体腺瘤	垂体腺瘤##垂体良性肿瘤	2
右侧鼻翼皮肤肿物	鼻部肿物##皮肤肿物	2
支气管炎肺气肿	支气管炎##肺气肿	2
重度骨质疏松(绝经期)	重度骨质疏松##绝经期	2
额骨小骨瘤	额骨良性肿瘤##骨瘤	2
双肋缘明显外翻原因待查胃口差抵抗差	食欲不振##肋骨畸形	2
慢性心功能衰竭心功能3级c期	心功能III级(NYHA分级)##慢性心力衰竭	2
双卵巢低分化浆液性腺癌	卵巢恶性肿瘤##浆液性腺癌	2
非霍奇金血管免疫母细胞性T细胞淋巴瘤	非霍奇金淋巴瘤##血管免疫母细胞T-细胞淋巴瘤	2
毛细血管扩张光老化斑	毛细血管扩张症##日晒伤	2
结肠癌pT4N0M0	结肠恶性肿瘤##癌	2
急性化脓性阑尾炎并坏疽穿孔	急性化脓性阑尾炎伴穿孔##坏疽	2
急性脑梗死右侧颞顶枕叶梗死	脑梗死##多发性脑梗死	2
口咽癌综合治疗后	口咽恶性肿瘤##癌	2
肝内团片状低密度影待查CA其他	肝恶性肿瘤##癌	2
右卵巢未成熟畸胎瘤III期	未成熟型畸胎瘤##卵巢恶性肿瘤	2
左颊部及右舌部扁平苔藓	口腔扁平苔癣##舌扁平苔癣	2
双乳腺病伴部分导管扩张和上皮大汗腺化	乳房未特指的疾患##乳腺导管扩张症	2
上呼吸道感染;鼻窦炎?;腹泻	上呼吸道感染##鼻窦炎	2
胸腺鳞状细胞癌术后	胸腺恶性肿瘤##鳞状细胞癌	2
慢性阻塞性肺疾病伴肺部感染	慢性阻塞性肺疾病##肺部感染	2
膀胱粘膜上皮鳞状化生白斑	膀胱白斑##膀胱鳞状上皮化生	2
头部蜂蜇伤复诊	蜂螫伤##头部损伤	2
卵巢癌IIIC期	卵巢恶性肿瘤##癌	2
睾丸恶性淋巴瘤	睾丸淋巴瘤##恶性淋巴瘤	2
胃窦中低分化腺癌IV期	胃窦恶性肿瘤##腺癌	2
盆底功能障碍性疾病阴道前壁膨出Ⅱ期	阴道脱垂##盆底功能障碍	2
室性早搏射频消融术后	室性期前收缩##心脏射频消融术后	2
中耳炎(伴急性结膜炎)	中耳炎##急性结膜炎	2
椎基底动脉系统TIA单纯性髙胆固醇血症	短暂性脑缺血发作##高胆固醇血症	2
多发骨M原发不明	骨继发恶性肿瘤##转移性肿瘤	2
原发性支气管肺癌(左上肺鳞癌，cT2aN3M0 ⅢB期PS 1分)	左肺上叶恶性肿瘤##鳞状细胞癌	2
右手掌疤痕挛缩伴食指屈指肌腱粘连	瘢痕挛缩##手指屈肌肌腱粘连	2
小乳症鞍鼻	先天性小乳##鞍鼻	2
双叶甲状腺乳头状癌	甲状腺恶性肿瘤##甲状腺乳头状癌	2
幼年性毛细血管瘤	幼年性血管瘤##毛细血管瘤	2
左食中环小指坏死缺失	后天性单侧手指缺失##手坏死	2
PANCREATICCANCER	胰腺恶性肿瘤##癌	2
左乳癌	乳腺恶性肿瘤##癌	2
41楔状缺损3646磨损	牙齿楔状缺损##牙齿磨损	2
头部、左膝外伤	下肢未特指的损伤,水平未特指##头部损伤	2
原发不孕卵巢储备功能减低	原发不孕##卵巢功能减退	2
慢性肾脏病骨与矿物质紊乱	慢性肾病##矿物质代谢紊乱	2
肾囊肿伴囊壁钙化	肾钙化##肾囊肿	2
脾虚大便不调痹症高尿血酸血症	大便习惯改变##高尿酸血症	2
先天性肺囊肿并感染	先天性肺囊肿##肺部感染	2
脾肿大脾内囊样灶	脾大##脾囊肿	2
双主动脉弓气管软化伴下段狭窄	先天性双主动脉弓##气管狭窄	2
原发不孕男方无精子	无精子症##男性不育症	2
妊娠滋养细胞肿瘤第一次化疗后	化学治疗##滋养细胞病	2
喘大气待查：心肌损伤	喘息##心肌损害	2
双侧副舟骨源性平足症	先天性足副舟骨##扁平足	2
双肩跌伤	摔伤##肩部损伤	2
十二指肠降段腺瘤	十二指肠良性肿瘤##腺瘤	2
长期胃口差间歇性清晨眼睑浮肿	眼睑水肿##食欲不振	2
颅脑创伤后意识障碍	头部损伤##意识障碍	2
椎基底动脉血栓形成	椎动脉血栓形成##基底动脉血栓形成	2
高尿酸植物神经紊乱	植物神经功能紊乱##高尿酸血症	2
肝脏恶性肿瘤介入治疗	肝恶性肿瘤##恶性肿瘤介入治疗	2
急性广泛前壁ST段抬高型心肌梗	急性广泛前壁心肌梗死##急性ST段抬高型心肌梗死	2
小脑萎缩性共济失调	小脑萎缩##共济失调	2
急性粒单核细胞白血病	急性粒单核细胞白血病(M4型)##急性粒-单核细胞白血病	2
特指胎盘疾病胎盘残留	胎盘部分残留不伴出血##其他的胎盘疾患	2
乳腺浸润性导管癌Ⅱ-Ⅲ级	乳腺恶性肿瘤##浸润性导管癌	2
宫内环下移2绝经	避孕环移位##绝经期	2
喉咽癌	喉咽恶性肿瘤##癌	2
胃体癌	胃体恶性肿瘤##癌	2
输卵管腺癌	输卵管恶性肿瘤##腺癌	2
食管胃静脉曲张	胃静脉曲张##食管静脉曲张	2
外伤性C4-5不稳定伴不全瘫	不完全性瘫痪##颈椎不稳定	2
双卵巢中分化浆液性乳头状囊腺癌	卵巢交界性肿瘤##乳头状浆液性囊腺瘤	2
多发颅颈椎动脉狭窄伴斑块狭窄	椎动脉狭窄##椎动脉斑块	2
构音障碍和言语讷吃	构音障碍##言语讷吃	2
甲状腺功能亢进桥本氏甲亢可能性大	慢性淋巴细胞性甲状腺炎##甲状腺功能亢进症	2
肩胛骨癌	肩胛骨恶性肿瘤##癌	2
盆腔包块待查：1）卵巢囊肿？2）卵巢肿瘤？3)炎性包块？	盆腔肿物##卵巢囊肿	2
左肺陈旧性病灶斑片条索影	肺病##肺部阴影	2
冠状动脉粥样硬化(狭窄)	冠状动脉狭窄##冠状动脉粥样硬化	2
右肘跌伤待查	上肢损伤##摔伤	2
胸壁未分化高级别多形性肉瘤	胸部恶性肿瘤##肉瘤	2
慢阻肺肺心病急性发作	肺源性心脏病##慢性阻塞性肺疾病	2
(腿肿痛)	下肢肿胀##下肢疼痛	2
舌根鳞状细胞癌	舌根恶性肿瘤##鳞状细胞癌	2
化疗后白细胞下级	化疗药物反应##白细胞减少	2
脑膜瘤(术后)	脑膜瘤##脑术后	2
卵巢透明细胞癌IC期	透明细胞癌##卵巢恶性肿瘤	2
宫颈非角化型鳞状细胞癌	子宫颈恶性肿瘤##鳞状细胞癌	2
子宫颈小细胞癌	子宫颈恶性肿瘤##小细胞癌	2
臀部软组织尤文肉瘤	臀部恶性肿瘤##尤因肉瘤	2
卵巢子宫内膜样腺CA	卵巢恶性肿瘤##子宫内膜样腺癌	2
痔疮术后出血	痔##出血	2
面颈部放疗后淋巴回流障碍	淋巴回流障碍##放射治疗	2
右髋臼边缘骨质破坏待查撞击综合征	骨质破坏##髋关节撞击综合征	2
升结肠低级别管状腺瘤	升结肠良性肿瘤##管状腺瘤	2
肝病综合征（巨细胞病毒感染）	未特指的肝病##巨细胞病毒感染	2
不慎被玻璃管割伤右手食指	手指开放性损伤##玻璃割伤	2
前列腺癌综合治疗后	前列腺恶性肿瘤##癌	2
低钾低钠原因待查	低钾血症##低钠血症	2
结肠息肉腺瘤	结肠良性肿瘤##息肉样腺瘤	2
化疗后肝功能下降	化疗药物反应##肝功能异常	2
三系下降待查血液系统疾病嗜血综合症	全血细胞减少##噬血细胞综合征	2
肾透明细胞癌伴囊性变	肾恶性肿瘤##透明细胞癌	2
女性右侧乳腺癌	乳腺恶性肿瘤##癌	2
腰椎oa心脏病	未特指的心脏病##脊椎退行性病变	2
高胆固醇血症/上感	高胆固醇血症##上呼吸道感染	2
双侧骶尾部巨大褥疮扩大清创负压成形术	压疮##清创术后	2
意识障碍待查肠管积气原因待查	肠胀气##意识障碍	2
左小腿皮肤撕脱伴皮肤组织缺损	小腿撕脱伤##下肢皮肤缺损	2
右外耳道乳头状瘤	外耳道良性肿瘤##乳头状瘤	2
创伤后应激障碍＋器质性脑病	脑病[器质性脑病]##创伤后应激障碍	2
胃窦多发性管状腺瘤	胃良性肿瘤##管状腺瘤	2
距肛门50cm管状腺瘤低级别	管状腺瘤##结肠良性肿瘤	2
右乳多发纤维腺瘤	乳腺良性肿瘤##纤维腺瘤	2
直肠溃疡型中分化乳头状管状腺癌	直肠恶性肿瘤##乳头状管状腺癌	2
左眼睑挫裂伤	眼睑裂伤##眼睑挫伤	2
慢性阻塞性肺气肿疾病急性加重期	阻塞性肺气肿##慢性阻塞性肺疾病急性加重	2
右肾结石术后	肾结石##肾术后	2
颈髓缺血变性C45C56水平	脊髓变性##脊髓缺血	2
睡眠障碍伴焦虑	睡眠障碍##焦虑状态	2
急性化脓性阑尾炎伴坏疽	急性化脓性阑尾炎##坏疽	2
右上肺周围型低分化腺癌Ⅳ期	右肺上叶恶性肿瘤##腺癌	2
风湿性瓣膜病	风湿性心脏病##心脏瓣膜病	2
猝死型冠心病	心源性猝死##冠状动脉粥样硬化性心脏病	2
右上臂BOWEN病	上肢恶性肿瘤##鲍恩病	2
胸腰椎右侧股骨占位	下肢占位##脊柱占位	2
眼浮肿面部红肿	水肿##面部肿胀	2
右乳恶性分叶状肿瘤	乳腺恶性肿瘤##恶性叶状瘤	2
左肘关节肱骨外侧髁陈旧撕脱性骨折	肱骨外髁骨折##陈旧性肱骨骨折	2
子宫颈非角化型鳞状细胞癌	子宫颈恶性肿瘤##非角化的鳞状细胞癌	2
骶前神经鞘瘤术后	神经鞘瘤##骶前良性肿瘤	2
细支气管肺泡癌	细支气管-肺泡癌##肺恶性肿瘤	2
肋软骨瘤可能	肋骨良性肿瘤##软骨瘤	2
原发性肝癌（右）肝动脉插管化疗栓塞术后	肝恶性肿瘤##癌	2
多发性子宫肌瘤富于细胞型	子宫多发性平滑肌瘤##细胞性平滑肌瘤	2
软腭鳞状细胞癌	软腭恶性肿瘤##鳞状细胞癌	2
肛门和直肠疾患痔疮	痔##肛门和直肠未特指的疾病	2
胃贲门低分化腺癌	贲门恶性肿瘤##腺癌	2
肘关节骨折术后	肘关节骨折##骨折术后	2
胎盘残留-胎盘植入	胎盘部分残留不伴出血##胎盘植入不伴出血	2
上呼吸道疾病细菌性	上呼吸道感染##细菌感染	2
垂体泌乳素腺瘤术后	垂体泌乳素瘤##垂体术后	2
肌萎缩原因待查脊髓前角受累可能性大	肌肉萎缩##脊髓前角病变	2
双腿肿痛	下肢肿胀##下肢疼痛	2
脑白质深部多发缺血脱髓鞘改变	脱髓鞘性白质脑病##脑血管供血不足	2
左肺尖气肿纤维灶	肺诊断性影像异常##肺气肿	2
右额颞叶间变型少突胶质细胞瘤综合治疗后	间变型少突神经胶质细胞瘤##额颞叶恶性肿瘤	2
升结肠LST管状腺瘤	升结肠良性肿瘤##管状腺瘤	2
脾区管状腺瘤	脾良性肿瘤##管状腺瘤	2
腰4椎体爆破性骨折伴不全瘫	腰椎骨折L4##不完全性瘫痪	2
主动脉弓缩窄CHF	主动脉弓狭窄##充血性心力衰竭	2
右腹股沟伤口愈合不良	腹股沟损伤##开放性损伤愈合不良	2
急性前壁心肌再梗死KillipⅢ级	急性前壁再发心肌梗死##KillipIII级	2
肛裂并感染	肛裂##感染	2
非创伤性颅内出血后遗症	非创伤性颅内出血##颅内出血后遗症	2
甲状腺右叶乳头状微癌	甲状腺恶性肿瘤##乳头状微小癌	2
双眼泡性结膜炎，左眼结膜结石	泡性结膜炎##结膜结石	2
低锌低铁	锌缺乏##铁缺乏	2
纵隔霍奇金淋巴瘤	纵隔淋巴瘤##霍奇金淋巴瘤	2
肢体肿胀(静脉曲张)	肢体肿胀##静脉曲张	2
双手皮肤破损及水泡	手部水泡##手部开放性损伤	2
乳腺非霍奇金淋巴瘤	乳腺淋巴瘤##非霍奇金淋巴瘤	2
原发性高血压并发重度子痫前期	原发性高血压##重度子痫前期	2
宫腔赘生物宫颈管赘生物	子宫息肉##子宫颈息肉	2
肝病血吸虫肝改变可能	血吸虫病##未特指的肝病	2
右侧肾盂输尿管积水	输尿管积水##肾积水	2
1多发性腔隙性梗塞	腔隙性脑梗死##多发性脑梗死	2
急性喉炎并喉梗阻I度	急性喉炎##喉梗阻	2
Z足癣继发感染	足癣##足感染	2
陈发性房颤，窦缓	阵发性心房颤动##窦性心动过缓	2
癫痫灶切除术后	癫痫##脑术后	2
胸水待查结核性可能性大恶性不除外	结核性胸腔积液##恶性胸腔积液	2
脑白质变性5神经症	脑白质病##神经症性障碍	2
胸下段食管鳞状细胞癌	食管胸下段恶性肿瘤##鳞状细胞癌	2
腰2椎体压缩性性骨折伴截瘫	腰椎压缩性骨折##截瘫[双下肢瘫痪]	2
右下牙龈高分化鳞状细胞癌	牙龈恶性肿瘤##鳞状细胞癌	2
霍奇金淋巴结结节硬化型化疗后IIB	结节性硬化型霍奇金病##化学治疗	2
左侧基底节血管性病变，静脉畸形伴海绵状血管瘤?	基底节病变##海绵状血管瘤	2
右臀部皮脂腺囊肿感染	皮脂腺囊肿##感染	2
左手抖动原因待查帕金森氏病	帕金森病##不自主运动	2
右肾切开取石术后	肾结石##肾术后	2
上腭癌	腭恶性肿瘤##癌	2
脑白质缺血脱髓鞘病变	脑血管供血不足##脱髓鞘性白质脑病	2
头面颈前胸开水烫伤	沸水烫伤##躯干部烫伤	2
左耳外耳道疖肿耳廓疖肿	外耳道疖##耳廓疖	2
双上睑闭合不全右上睑皮肤全层缺失	眼睑闭合不全[兔眼]##皮肤缺损	2
甲状腺囊肿切除术后	甲状腺囊肿##甲状腺术后	2
结肠腺瘤	结肠良性肿瘤##腺瘤	2
右隐睾包茎	单侧隐睾##包茎	2
结肠粘膜低级别管状腺瘤粟粒大2块	结肠良性肿瘤##管状腺瘤	2
右下肺间质病变原因陈旧性病变	间质性肺病##肺病	2
左前臂犬咬伤	被狗咬伤##前臂开放性损伤	2
冠心病;上呼吸道感染;外伤	冠状动脉粥样硬化性心脏病##上呼吸道感染	2
腰腹疼	腰痛##腹痛	2
急性脑梗死右侧额叶岛叶室旁多发急性梗塞	脑梗死##多发性脑梗死	2
左股骨中段癌	股骨恶性肿瘤##癌	2
特指手术后状态(双下肢大隐静脉曲张术后)	大隐静脉曲张##静脉曲张术后	2
阴道和外阴特指炎症	外阴炎##阴道炎	2
右膝外翻重度左膝内翻轻度	膝外翻##膝内翻	2
多发转移癌	多部位继发恶性肿瘤##转移性癌	2
右上肺小细胞癌	右肺上叶恶性肿瘤##小细胞癌	2
慢性肾脏病并急性肾衰	慢性肾病##急性肾衰竭	2
WHO肺高压心功能III级	肺动脉高压##心功能III级(NYHA分级)	2
直肠隆起型中分化腺癌	直肠恶性肿瘤##腺癌	2
颈椎间盘突出症伴椎管狭窄	颈椎间盘突出##颈椎管狭窄	2
右乳外上象限纤维腺瘤	乳腺良性肿瘤##纤维腺瘤	2
肝脾挫伤	肝挫伤##脾损伤	2
右梨状窝癌	梨状窝恶性肿瘤##癌	2
颅内真菌感染	颅内感染##真菌感染	2
垂体大腺瘤	垂体良性肿瘤##垂体腺瘤	2
双侧额叶脑出血术后	额叶出血##脑术后	2
火焰烧伤面部	火焰烧伤##面部烧伤	2
感音神经性听觉减退老年性听损	老年性聋##感音神经性聋	2
直肠绒毛状管状腺瘤伴低度上皮内瘤变	直肠良性肿瘤##管状绒毛状腺瘤	2
肋骨转移癌	肋骨继发恶性肿瘤##转移性癌	2
绝经后IUD断裂嵌頓肌层内外院取环失败后	避孕环残留##避孕环嵌顿	2
右扁桃体癌综合治疗后	扁桃体恶性肿瘤##癌	2
脑白质缺血脱髓鞘改变	脱髓鞘性白质脑病##脑血管供血不足	2
甲状腺非霍奇金淋巴瘤	甲状腺淋巴瘤##非霍奇金淋巴瘤	2
鼻咽右侧壁未分化型非角化性癌	鼻咽侧壁恶性肿瘤##未分化的癌	2
食管下段低分化鳞癌	食管下三分之一的恶性肿瘤##鳞状细胞癌	2
Graves病合并桥本甲状腺炎	弥漫性甲状腺肿伴甲状腺功能亢进[Graves病]##自身免疫性甲状腺炎[桥本病]	2
双下肢无力原因待查腰椎病所致可能性大	肢体无力##腰椎病	2
右膝髌股关节退变股骨内髁骨梗死	单侧膝关节骨性关节病##骨坏死	2
卵巢无性细胞瘤	卵巢恶性肿瘤##无性细胞瘤	2
L5椎体压缩性骨折	腰椎压缩性骨折##腰椎骨折L5	2
妊娠合并B族链球菌感染	链球菌感染##妊娠状态	2
右乳房皮肤Paget's病	乳腺恶性肿瘤##乳房佩吉特病	2
肾上腺增生引起的原发性醛固酮过多症	肾上腺增生##原发性醛固酮增多症[低肾素性醛固酮增多症]	2
臀部疖肿金黄色葡萄球菌	臀部疖##金黄色葡萄球菌感染	2
脑动脉瘤包裹术后	脑动脉瘤##脑术后	2
下肢浅静脉曲张术后	下肢静脉曲张##静脉曲张术后	2
不育待查严重弱精子症	男性不育症##男方弱精症	2
纵膈子宫，宫腔镜检查	子宫纵隔##宫腔镜检查	2
双侧眉弓软组织挫裂伤	眉弓挫伤##眉弓裂伤	2
双侧髌骨骨质破坏痛风性	骨质破坏##痛风	2
考虑左侧颊粘膜扁平苔藓B8过小牙	口腔扁平苔癣##过小牙	2
左膝退变伴游离体	膝骨关节病##膝关节游离体	2
原发腹膜癌	腹膜恶性肿瘤##癌	2
双侧卵巢中低分化浆液性乳头状腺癌	卵巢恶性肿瘤##乳头状浆液性腺癌	2
1双侧小乳症2Tunner综合症	特纳综合征[Turner综合征]##先天性小乳	2
舌右侧缘鳞癌cT0M0Ⅱ期	舌缘恶性肿瘤##鳞状细胞癌	2
右侧盆腔异位肾伴旋转不良	肾异位##先天性肾旋转不良	2
胸腰椎多发压缩性骨折	胸椎压缩性骨折##腰椎压缩性骨折	2
胃腺管状腺瘤	胃良性肿瘤##管状腺瘤	2
右小腿皮肤坏死缺损	下肢皮肤坏死##下肢皮肤缺损	2
脾脏符合慢性淤血性脾肿大并副脾组织	先天性副脾##慢性充血性脾大	2
脑缺血脱髓鞘右半身僵	脱髓鞘性脑病##脑血管供血不足	2
沸水烫伤8%浅Ⅱ&deg8%颈躯干双上肢	沸水烫伤##多发烫伤	2
脊髓松解后大小便失禁	尿失禁##大便失禁	2
上段食管鳞状细胞癌	食管上三分之一的恶性肿瘤##鳞状细胞癌	2
风湿性心脏瓣膜病	风湿性心脏病##心脏瓣膜病	2
双肾输尿管梗阻性病变	梗阻性肾病##输尿管梗阻	2
右乳纤维性瘤	乳腺良性肿瘤##纤维腺瘤	2
4.右小腿外伤伤口感染	小腿损伤##腿部感染	2
胆囊息肉伴慢性胆囊炎	胆囊息肉##慢性胆囊炎	2
右侧小脑半球腔隙性梗死	小脑梗死##腔隙性脑梗死	2
右乳多发导管内乳头状瘤	导管内乳头状瘤##乳腺良性肿瘤	2
上颌窦癌	上颌窦恶性肿瘤##癌	2
左侧肾盂癌	肾盂恶性肿瘤##癌	2
右侧甲状腺结节性甲肿伴囊性变	结节性甲状腺肿##甲状腺囊肿	2
停经354周MR提示胎儿空肠下段闭锁	妊娠状态##先天性空肠闭锁	2
右臂皮肤纤维组织细胞瘤	上肢皮肤良性肿瘤##纤维组织细胞瘤	2
右肘游离体创伤性OA	肘关节内游离体##肘骨关节病	2
左腕小多角骨及钩骨撕脱性骨折	小多角骨骨折##钩骨骨折	2
左腕小多角骨三角骨撕脱性骨折	小多角骨骨折##三角骨骨折	2
膀胱mt术后	膀胱恶性肿瘤##膀胱术后	2
十二指肠乳头符合管状腺瘤	十二指肠良性肿瘤##管状腺瘤	2
晚期胃腺癌	胃恶性肿瘤##腺癌	2
胆囊切开取石术后	胆囊结石##胆囊术后	2
慢性肺源心脏病右室增大心功4级	慢性肺源性心脏病##心功能IV级(NYHA分级)	2
慢性泪囊炎术后	慢性泪囊炎##眼术后	2
右乳占位（MT可能）	乳腺恶性肿瘤##乳房占位	2
食管下段恶性肿瘤中医治疗	食管下三分之一的恶性肿瘤##恶性肿瘤中医治疗	2
右肺上叶支气管新生物性质待查炎性病灶	支气管息肉##支气管炎	2
胸骨及左侧1-4肋骨折	肋骨多发性骨折伴第一肋骨骨折##胸骨骨折	2
3胸腹部肿瘤	胸部肿瘤##腹部肿瘤	2
右乳腺癌IV期	乳腺恶性肿瘤##癌	2
附件内膜异位症	输卵管子宫内膜异位症##卵巢子宫内膜异位症	2
双下肢无力待查--腰椎间盘病变	肢体无力##椎间盘疾患	2
孕31周、妊娠糖尿病？	妊娠合并糖尿病##孕31周	2
肺非典型类癌	非典型类癌性瘤##肺恶性肿瘤	2
弥漫大B细胞淋巴瘤复发	弥漫大B细胞淋巴瘤##恶性肿瘤复发	2
右肺穿刺活检腺癌	右肺恶性肿瘤##腺癌	2
多发性周围神经运动支感觉支脱髓鞘异常	脱髓鞘病##多发性神经病[多发性神经炎/周围神经炎]	2
肺瘢痕癌	肺恶性肿瘤##癌	2
孕5月+先兆临产	先兆临产##孕20周	2
慢性肺部疾病合并肺心病	肺病##肺源性心脏病	2
中高分化子宫内膜样腺癌	子宫内膜样腺癌##子宫内膜恶性肿瘤	2
卵巢腺癌III期	卵巢恶性肿瘤##腺癌	2
EST柱状球囊扩张术胆管取石术ENBD后	胆管结石##胆道术后	2
肝组织内分化腺癌	肝恶性肿瘤##腺癌	2
泪溢左眼高眼压	高眼压症##泪溢	2
扭伤咽炎上感肾虚	咽炎##上呼吸道感染	2
咯血(感染?)	感染##咯血	2
不自主抽动查因睡眠行为障碍	不自主运动##快动眼睡眠行为障碍	2
左膝关节腘窝囊肿	膝关节囊肿##腘窝囊肿	2
颈动脉狭窄支架术后	颈动脉狭窄##血管支架植入术后状态	2
右腕掌割伤	腕部开放性损伤##手掌开放性损伤	2
右下肢浅静脉曲张术后	下肢静脉曲张##静脉曲张术后	2
右膝外侧半月Ⅲ裂撕轻度OA	单侧膝关节骨性关节病##膝外侧半月板撕裂	2
猫抓伤病史	被其他哺乳动物咬伤或抓伤,在未特指场所##损伤史	2
滑膜软骨瘤	软骨瘤##滑膜良性肿瘤	2
非霍奇金弥漫大B细胞淋巴瘤ⅡE期A组	非霍奇金淋巴瘤##弥漫大B细胞淋巴瘤	2
胃粘液腺癌	粘液腺癌##胃恶性肿瘤	2
右眼枪伤	意外枪伤##眼部开放性损伤	2
吞咽堵塞感查因贲门迟缓	吞咽障碍##贲门失弛缓	2
右卵巢成熟性囊性畸胎瘤蒂扭转	成熟型囊性畸胎瘤##卵巢良性肿瘤	2
面部白斑浮肿原因	局部水肿##白斑病,不可归类在他处者	2
胃低-中分化腺癌	胃恶性肿瘤##腺癌	2
胃肠积气	胃胀气##肠胀气	2
妊娠合并生殖道无乳链球菌感染	妊娠状态##链球菌感染	2
外阴癌	外阴恶性肿瘤##癌	2
鼻部疤痕挛缩缺损	瘢痕挛缩##鼻部瘢痕	2
双肺上叶陈旧性病变双肺下叶间质性病变	间质性肺病##肺病	2
复发性滤泡淋巴瘤	滤泡淋巴瘤##恶性肿瘤复发	2
脑缺血并周围神经病変脑记忆力减退	脑血管供血不足##多发性神经病[多发性神经炎/周围神经炎]	2
右上肢正中神经鞘瘤	正中神经良性肿瘤##神经鞘瘤	2
盆腔粘液性肿瘤	盆腔良性肿瘤##粘液瘤	2
白内障晶状体置换术后（右）	白内障##眼术后	2
慢性鼻-鼻窦炎伴右鼻息肉	慢性鼻窦炎##鼻息肉	2
颈淋巴肿大大便干燥	其他大便异常##颈淋巴结肿大	2
垂体功能障碍待排1器质性精神障碍	垂体功能低下##器质性精神障碍	2
急性粒细胞白血病MCR2	急性粒细胞性白血病##急性粒细胞白血病	2
巧囊术后	卵巢巧克力样囊肿##卵巢术后	2
盆腔多发转移	盆腔继发恶性肿瘤##转移性肿瘤	2
1左先天性睑下垂2右下肢肌萎缩待查	先天性上睑下垂##下肢肌肉萎缩	2
不孕子宫极度后屈	子宫后屈##未特指的女性不孕症	2
输卵管癌ⅢC期	输卵管恶性肿瘤##癌	2
造瘘口部分肠管坏死伴坍陷	肠坏死##人工造口状态	2
右侧胫腓骨骨折	腓骨骨折##胫骨骨折	2
结肠溃疡型是分化腺癌	结肠恶性肿瘤##腺癌	2
右颞叶海马异常信号缺血脱髓鞘改变	脱髓鞘性脑病##脑血管供血不足	2
慢性重度萎缩伴肠化hp	肠上皮化生##幽门螺旋杆菌感染	2
直肠绒毛管状腺瘤直肠绒毛管状腺瘤	管状绒毛状腺瘤##直肠良性肿瘤	2
胸髓压迫症伴截瘫	脊髓压迫症##未特指的截瘫	2
股癣,毛周角化症	股癣##毛发苔藓	2
右下肢外伤清创缝合术并感染	下肢未特指的损伤,水平未特指##感染	2
手足廯	手癣##足癣	2
前列腺癌晚期	前列腺恶性肿瘤##癌	2
鳞状上皮化生伴CINⅠCINⅡ累及腺体	子宫颈上皮瘤样病变[CIN]I级##宫颈上皮瘤样病变[CIN]II级	2
白内障(右眼术后)	白内障##眼术后	2
双眼黄斑裂孔术后	黄斑裂孔##眼术后	2
新生儿缺氧缺血性脑病并颅内出血	新生儿缺氧缺血性脑病##颅内出血	2
扩张型心脏病酒精性心脏病可能性大	扩张性心肌病[充血性心肌病]##酒精性心肌病	2
背部pnet化疗	原始性神经外胚瘤##化学治疗	2
右侧头臂干粥样硬化伴狭窄	动脉粥样硬化##动脉狭窄	2
右乳纤维腺瘤伴钙化	乳腺良性肿瘤##纤维腺瘤	2
下肢静脉曲张伴浅静脉血栓形成	下肢静脉曲张##下肢静脉血栓形成	2
双眼脉络膜缺损右侧黄斑病变	视网膜病##先天性脉络膜缺损	2
（左外耳道）鳞状细胞癌，中分化。	外耳道皮肤恶性肿瘤##鳞状细胞癌	2
尿布疹5卵圆孔未闭	卵圆孔未闭##尿布性皮炎	2
意识丧失伴肢体抽搐	意识丧失##抽搐状态	2
口腔溃疡并感染	口腔粘膜溃疡##口腔感染	2
滤泡性淋巴瘤伴弥漫性大B细胞淋巴瘤转化	滤泡淋巴瘤##弥漫大B细胞淋巴瘤	2
右乳纤维囊性乳腺病伴钙化	乳房纤维囊性乳腺病##乳腺钙化	2
胆囊息肉并胆囊炎	胆囊息肉##胆囊炎	2
右眼眶外侧、右手腕部外伤	眼和眶未特指的损伤##腕部损伤	2
左手背皮肤软组织撕脱并缺损	手部开放性损伤##皮肤缺损	2
末端回肠回盲部升结肠横结肠慢性炎症伴溃疡	慢性结肠炎##结肠溃疡	2
右腓总神经鞘瘤	下肢周围神经和自主神经良性肿瘤##神经鞘瘤	2
右下肢骨缺损骨不连	骨折不连接[假关节]##下肢骨折	2
右乳腺非特殊型浸润性癌	乳腺恶性肿瘤##癌	2
右足底皮肤挫裂伴肌肉坏死	足部挫伤##足坏死	2
1枕部皮肤坏死伴缺损	头面部皮肤坏死##皮肤缺损	2
双手足发育不良	先天性手畸形##先天性足畸形	2
待查重叠重合征低钾血征	低钾血症##重叠综合征	2
主动脉瓣钙化并轻度关闭不全	主动脉瓣关闭不全##主动脉瓣钙化	2
停经312周10单活胎胎儿脊髓低位	妊娠状态##先天性脊髓低位	2
左侧肾上腺占位伴高血压	高血压##肾上腺占位	2
胃隆起性病变SMTCa	胃恶性肿瘤##癌	2
前列腺癌恶性肿瘤	前列腺恶性肿瘤##癌	2
铅高多动	铅中毒##注意缺陷与多动障碍	2
急性坏疽性阑尾炎并周围脓肿	急性坏疽性阑尾炎##阑尾周围脓肿	2
特指胎盘疾病组织物残留	其他的胎盘疾患##胎盘部分残留不伴出血	2
右眼视障待查缺血	视觉障碍##眼动脉缺血	2
乳癌免疫力低下	乳腺恶性肿瘤##癌	2
L5压缩性骨折	腰椎骨折L5##腰椎压缩性骨折	2
左膝挫裂伤	膝部挫伤##下肢撕裂伤	2
胰腺内分泌癌	内分泌胰腺恶性肿瘤##癌	2
腰背部脂肪堆积症	腰部脂肪增多症##背部脂肪增多症	2
上呼吸道的疾病右下肢无力	肢体无力##未特指的上呼吸道疾病	2
前列腺增生症术后	前列腺增生##前列腺术后	2
双下肢浮肿待查低白蛋白血症可能性大	低蛋白血症##下肢水肿	2
足部软组织损伤伴感染	足部损伤##足软组织感染	2
晚孕(上感)	妊娠状态##上呼吸道感染	2
胸膜转移癌	转移性癌##胸膜继发恶性肿瘤	2
妊娠滋养细胞肿瘤第八次化疗	滋养细胞病##化学治疗	2
左手中指恶性黑素瘤	手指恶性黑色素瘤##恶性黑色素瘤	2
胎盘疾病胎盘残留	胎盘部分残留不伴出血##未特指的胎盘疾患	2
右肺下叶癌	右肺下叶恶性肿瘤##癌	2
升结肠癌，pT2N0；	升结肠恶性肿瘤##癌	2
肝功能失代偿期腹水形成	肝硬化失代偿期##腹水	2
双乳腺增生并导管扩张	乳腺增生##乳腺导管扩张症	2
高CA125神经元特异性烯醇化酶血症	CA125升高##肿瘤标记物升高	2
2型糖尿病\骨质疏松症	2型糖尿病##骨质疏松	2
高血压良性小动脉肾硬化症	小动脉性肾硬化##高血压	2
右胫腓骨骨缺损性骨不连	腓骨骨折不连接##胫骨骨折不连接	2
右上叶GGO不除外恶性	肺部阴影##肺恶性肿瘤	2
头皮鳞癌	鳞状细胞癌##头皮恶性肿瘤	2
左侧上颌窦炎性假瘤	上颌窦肿物##炎性假瘤	2
骨关节病(腘窝囊肿)	腘窝囊肿##骨关节病	2
脑内多发缺血性脱髓改变	脱髓鞘性脑病##脑血管供血不足	2
前列腺特指疾病PSA增高原因待查	前列腺其他特指的疾患##PSA升高	2
患者肿瘤晚期恶液质变予静脉营养支持	恶病质##恶性肿瘤	2
右上肺腺癌Ⅳ期	右肺上叶恶性肿瘤##腺癌	2
急性脑梗死右侧颞顶枕叶急性梗塞灶	脑梗死##多发性脑梗死	2
左上肢开水烫伤	沸水烫伤##上肢烫伤	2
胸101112椎骨质破坏待查伴不全瘫	不完全性瘫痪##骨质破坏	2
白血病骨髓移植术后	骨髓移植术后##白血病	2
右侧DDHCroweIV型继发OA	先天性髋关节发育不良##髋骨关节病	2
前额蜂蜇伤	蜂螫伤##头部损伤	2
原发性胆汁性硬化失代偿期	原发性胆汁型肝硬化##肝硬化失代偿期	2
肝硬化脾亢(术后)	肝硬化##脾功能亢进	2
寄生虫脑脊髓膜炎广州管圆线虫可能性大	广州管圆线虫病##脑脊膜炎	2
一过性视物不清短暂性脑缺血可能性大	视觉模糊##短暂性脑缺血发作	2
右肘部跌伤	上肢损伤##摔伤	2
左侧股骨及髋臼骨纤维结构不良	髋骨纤维异常增殖症##股骨纤维结构不良	2
绝经3年外阴VIN1	外阴上皮内肿瘤[VIN],I级##绝经	2
多发性脑梗死灶后遗症期	多发性脑梗死##脑梗死后遗症	2
短暂性脑缺血高三酰甘油血症	短暂性脑缺血发作##高甘油三酯血症	2
左胫腓骨挫伤	胫骨骨折##腓骨骨折	2
梗死KillipII级陈旧性正后壁	KillipII级##陈旧性正后壁心肌梗死	2
肩背部劳损	肩颈部劳损##背部劳损	2
右肾肾实质萎缩伴多房囊性变	肾囊肿##肾萎缩	2
慢性肠炎伴肠功能紊乱	慢性肠炎##肠功能紊乱	2
GU治疗后复查CG伴糜烂	慢性胃炎##糜烂性胃炎	2
左中指及环指皮肤缺失伴坏死	后天性单侧手指缺失##手坏死	2
肩背冷痛月经先期	背痛##肩痛	2
结肠腺癌Ⅳ期	结肠恶性肿瘤##腺癌	2
凝血功能障碍维生素K依赖性	凝血功能障碍##维生素K缺乏	2
双侧输尿管肾盂肾盏积液	肾积水##输尿管积水	2
痣，甲白点	痣##白甲	2
肝胆管粘液腺癌	肝胆管恶性肿瘤##粘液腺癌	2
右侧髌骨骨折术后	髌骨骨折##骨折术后	2
右侧股四头肌送检横纹肌组织部分萎缩变性	肌纤维变性##下肢肌肉萎缩	2
阴道鳞状细胞癌	阴道恶性肿瘤##鳞状细胞癌	2
骨髓增殖性肿瘤（血小板增多症）	慢性骨髓增殖性肿瘤##血小板增多	2
发作性双下肢无力待查胸髓病变待除外	肢体无力##脊髓病	2
视网膜裂孔激光术后	视网膜裂孔##眼术后	2
不育待查重度弱精子症	男性不育症##男方弱精症	2
外科切口瘢痕相关行房扑消融术后	心脏射频消融术后##手术后瘢痕	2
横结肠低分化腺癌	横结肠恶性肿瘤##腺癌	2
右侧舌鳞癌	舌恶性肿瘤##鳞状细胞癌	2
腹膜转移	腹膜继发恶性肿瘤##转移性肿瘤	2
功血子宫肌瘤	子宫不规则出血##子宫平滑肌瘤	2
右侧肾盂癌	肾盂恶性肿瘤##癌	2
食管下段胃底静脉轻度曲张可能	胃底静脉曲张##食管静脉曲张	2
新生儿缺血缺氧性脑病并颅内出血	新生儿缺氧缺血性脑病##颅内出血	2
慢性萎缩性胃窦炎伴糜烂	慢性萎缩性胃炎##糜烂性胃炎	2
右眼睑裂斑双眼MGD	睑板腺功能障碍##睑裂斑	2
右上臂腕部皮肤抓伤	上臂开放性损伤##腕部开放性损伤	2
系统性硬皮病并间质性肺疾病	间质性肺病##系统性硬化症性肺病变	2
原发性支气管肺癌(左肺小细胞肺癌cT2bN2M0　局限期　PS0分)	左肺恶性肿瘤##小细胞癌	2
胃平滑肌瘤	平滑肌瘤##胃良性肿瘤	2
腹主动脉股动脉血栓	股动脉血栓形成##腹主动脉血栓形成	2
左手II-V指部分坏死左上臂皮肤坏死	上肢皮肤坏死##手坏死	2
颈腰椎间盘多发膨出	其他特指的椎间盘移位##腰椎间盘移位	2
前列腺癌T3N0M0	前列腺恶性肿瘤##癌	2
急性下壁ST段抬高型心肌梗死	急性下壁心肌梗死##急性ST段抬高型心肌梗死	2
先天性鞍鼻畸形	先天性鼻畸形##鞍鼻	2
上呼吸道感染，胃肠炎,心累待查?	上呼吸道感染##胃肠炎	2
慢性肾脏病合并矿物质骨质代谢异常	慢性肾病##矿物质代谢紊乱	2
慢性肾脏病矿物质及骨代谢异常	慢性肾病##矿物质代谢紊乱	2
右胸腰部软组织裂口	胸部开放性损伤##下背开放性损伤	2
左足平足症左后踝撞击症	踝关节撞击综合征##扁平足	2
右内踝玻璃割伤	踝部开放性损伤##玻璃割伤	2
胎盘疾病胎膜残留	胎膜部分残留不伴出血##未特指的胎盘疾患	2
胃间质瘤朮后	胃肠道间质性瘤##胃术后	2
胆囊切除术后腹壁粘连	胆囊切除术后粘连##腹壁粘连	2
贲门癌,胃镜用药 预防出血	贲门恶性肿瘤##癌	2
双耳感音神经聋老年性聋	老年性聋##双侧感音神经性聋	2
右肾重度萎缩功能严重不全	慢性肾功能不全##肾萎缩	2
右颊部鳞状细胞Ca	颊部恶性肿瘤##鳞状细胞癌	2
停搏后房室交界性逸搏	心脏停搏##结性逸搏	2
右足犬抓伤	足部开放性损伤##被狗抓伤	2
马凡综合征伴脊柱侧弯	马方综合征[Marfan综合征]##脊柱侧弯	2
冠状动脉疾病1急性心肌梗死2壁冠状动脉	急性心肌梗死##冠状动脉肌桥	2
胸腰椎椎间盘膨出	腰椎间盘移位##其他特指的椎间盘移位	2
右手拇指挤压离断伤	拇指挤压伤##手指开放性损伤	2
右背部转移	躯干继发恶性肿瘤##转移性肿瘤	2
肱骨干骨折(左侧,术后)	肱骨干骨折##骨折术后	2
右上肺周围型中分化肺癌IIIa	右肺上叶恶性肿瘤##癌	2
左下肢浮肿乏力	下肢水肿##乏力	2
对角支粥样硬化伴中-重度狭窄	冠状动脉粥样硬化##冠状动脉狭窄	2
子宫肌瘤雕核术后	子宫术后##子宫平滑肌瘤	2
右髂内动脉夹层动脉瘤	髂内动脉夹层##髂内动脉瘤	2
慢性浅表性胃炎并胃体糜烂	慢性浅表性胃炎##糜烂性胃炎	2
右下肢多形性未分化肉瘤	肉瘤##下肢恶性肿瘤	2
避孕问题，女扎术后	避孕问题##结扎输卵管绝育	2
宫颈中分化腺癌IB1期	子宫颈恶性肿瘤##腺癌	2
恶性黑素瘤右侧头顶部	头皮恶性黑色素瘤##恶性黑色素瘤	2
鼻窦乳头状瘤术后复发	鼻窦良性肿瘤##乳头状瘤	2
胃贲门溃疡型中分化腺癌	贲门恶性肿瘤##腺癌	2
头痛口干肝肾不足	头痛##口干	2
急性下壁心肌梗死恢复期	急性下壁心肌梗死##心肌梗死恢复期	2
老年性白内障(术前)	老年性白内障##眼术后	2
A45B45楔状缺损C5D4重度磨损	牙齿楔状缺损##牙齿磨损	2
右足背皮肤软组织坏死伴缺损	足坏死##皮肤缺损	2
结肠管状-绒毛状腺瘤	结肠良性肿瘤##管状绒毛状腺瘤	2
痔疮伴肛门癣	痔##皮真菌病	2
心率失常并心肌缺血	心肌供血不足##心律失常	2
右大腿内侧根部血管瘤？	血管瘤##血管瘤	2
胎盘植入胎盘组织广泛退变坏死伴钙盐沉积	钙质沉着症##胎盘植入不伴出血	2
输卵管未分化低分化癌	输卵管恶性肿瘤##未分化的癌	2
前列腺结节状增生伴间质慢性炎	前列腺增生##慢性前列腺炎	2
前列腺癌T3bN0M1	前列腺恶性肿瘤##癌	2
后纵隔神经鞘瘤	后纵隔良性肿瘤##神经鞘瘤	2
高血压伴心律失常	高血压##心律失常	2
糖尿病冠心病咽喉痛	糖尿病##冠状动脉粥样硬化性心脏病	2
月经增多原因待查宫内节育环嵌顿	避孕环嵌顿##月经过多	2
子宫阴道前壁膨出Ⅳ期阴道后壁膨出Ⅲ期	阴道前后壁脱垂##子宫阴道脱垂	2
大便干燥伴排便不畅待查	其他大便异常##排便困难	2
IVF治疗内异位高PRL血症	胚胎移植术后##高泌乳素血症	2
结肠癌不除外	结肠恶性肿瘤##癌	2
双眼高眼压左眼散粒肿	高眼压症##睑板腺囊肿[霰粒肿]	2
成熟型畸胎瘤右卵巢	卵巢良性肿瘤##成熟型囊性畸胎瘤	2
直肠上段腺瘤伴高级别上皮内瘤变	直肠良性肿瘤##腺瘤	2
肛周小细胞恶性肿瘤术后	小细胞型恶性肿瘤##肛周肿瘤	2
左眼先天性瞳孔异位伴闭锁	先天性瞳孔异位##先天性瞳孔闭锁	2
前降支次全闭塞右冠和左旋支高度狭窄	冠状动脉狭窄##冠状动脉闭塞	2
脑膜瘤放疗后	脑膜瘤##恶性肿瘤放疗	2
左颊及右舌粘膜扁平苔藓免疫异常	扁平苔癣##舌扁平苔癣	2
6化疗后肝功能轻度异常	化学治疗##肝功能异常	2
工作时与小偷搏斗摔伤	工作中的意外损伤##摔伤	2
鼻炎，传单？	鼻炎##传染性单核细胞增多症[腺性热]	2
膀胱平滑肌瘤	膀胱良性肿瘤##平滑肌瘤	2
卵巢继发癌	卵巢继发恶性肿瘤##继发性癌	2
高血压性肾脏病伴有慢性肾衰竭	高血压性肾病##慢性肾衰竭	2
掌骨骨折(术后)	掌骨骨折##骨折术后	2
急性胃炎/前列腺炎	急性胃炎##前列腺炎	2
右侧扁桃体鳞状细胞癌	鳞状细胞癌##扁桃体恶性肿瘤	2
升结肠管状腺瘤	升结肠恶性肿瘤##管状腺瘤	2
硬膜下积血左侧顶部双侧枕部蛛网膜下腔积血	蛛网膜下腔血肿##硬膜下血肿	2
腹痛：胃肠道寄生虫感染	腹痛##肠道寄生虫病	2
车祸机动车翻车致伤面部及腿部	面部损伤##下肢未特指的损伤,水平未特指	2
右手并指术后、上呼吸道感染	并指##上呼吸道感染	2
低白细胞血血症低中性粒细胞血症	白细胞减少##中性粒细胞减少症	2
降结肠溃疡型中分化腺癌	降结肠恶性肿瘤##腺癌	2
先天性眼底缺陷双眼失明	先天性眼底缺损##双眼盲	2
直肠绒毛管状腺瘤伴表面局灶腺体高级别?	直肠良性肿瘤##管状绒毛状腺瘤	2
双侧慢性鼻窦炎鼻息肉	鼻息肉##慢性鼻窦炎	2
腰椎骨折伴截瘫	腰椎骨折##截瘫[双下肢瘫痪]	2
特指胎盘疾病低置胎盘状态	其他的胎盘疾患##低置胎盘	2
阑尾开口横结肠管状腺瘤	管状腺瘤##横结肠良性肿瘤	2
右乳腺肿物切除术后	乳房肿物##乳腺术后	2
心肌酶异常原因风湿免疫系统疾病可能性大	心肌酶谱异常##风湿病	2
颈椎损伤伴不全瘫	不完全性瘫痪##脊柱损伤	2
右第骨骨折并肺挫伤	肋骨骨折##肺挫伤	2
骨关节病双膝关节置换术后	双侧膝关节骨性关节病##人工关节术后	2
颅内多发腔隙性梗塞	腔隙性脑梗死##多发性脑梗死	2
颅底骨放射性坏死	放射性损害##骨坏死	2
右上中肺腺癌 cT3N3M1b Ⅳ期EGFR基因检测野生型	右肺恶性肿瘤##腺癌	2
右足化脓性病灶切开延迟愈合	开放性损伤延期愈合##足感染	2
右侧骶髂关节退变并假关节形成	骨关节病##骨折不连接[假关节]	2
颈椎过伸伤伴不全瘫	不完全性瘫痪##脊柱损伤	2
继发性间质肺疾病	间质性肺病##放射性损害	2
右侧额颞叶脑挫裂伤出血	多发性大脑挫裂伤##创伤性颅内出血	2
左侧混合型FAI继发盂唇撕裂	髋关节撞击综合征##髋部损伤	2
急性脑血管病((脑梗死))	脑梗死##脑血管病	2
交界性逸搏伴完全性右束支阻滞	结性逸搏##完全性右束支传导阻滞	2
左肺癌	左肺恶性肿瘤##癌	2
升结肠腺癌术后	腺癌##升结肠恶性肿瘤	2
右乳恶性肿瘤的支持治疗	乳腺恶性肿瘤##恶性肿瘤支持治疗	2
卵巢囊肿术后	卵巢囊肿##卵巢术后	2
肺感染(发烧)	肺部感染##发热	2
脑肿瘤放疗后	脑恶性肿瘤##恶性肿瘤放疗	2
皮肤真皮及皮下组织癌转移	皮肤继发恶性肿瘤##转移性癌	2
小细胞低色素多发性抽动	不自主运动##低色素性小细胞性贫血	2
符合横结肠低级别绒毛管状腺瘤	横结肠良性肿瘤##管状绒毛状腺瘤	2
妊娠合并桥本氏甲状腺炎	自身免疫性甲状腺炎[桥本病]##妊娠状态	2
股二头肌半膜肌半腱肌腓肠肌比目鱼肌断裂	腓肠肌断裂##下肢肌肉肌腱断裂	2
冠心病-不稳定心绞痛	冠状动脉粥样硬化性心脏病##不稳定性心绞痛	2
右颊粘膜舌覆扁平苔藓免疫异常	口腔扁平苔癣##舌扁平苔癣	2
右侧颈总动脉粥样硬化斑块形成	颈总动脉斑块##颈动脉粥样硬化	2
右小腿皮肤擦挫伤	小腿挫伤##小腿擦伤	2
右下肢慢性静脉功能不全并瘀积性皮炎	下肢静脉功能不全##淤积性皮炎	2
右膝滑膜骨软骨瘤病	骨软骨瘤病##膝关节滑膜良性肿瘤	2
左上腹胸壁疼痛待查	上腹痛##前胸壁痛	2
子宫内膜息肉术后	子宫内膜息肉##子宫术后	2
气管癌	气管恶性肿瘤##癌	2
高热惊厥Sturge-weber综合症	热性惊厥##脑面血管瘤病[Sturge-Weber综合征]	2
肾癌(左)	肾恶性肿瘤##癌	2
脑缺血脱髓鞘锥体外系	脱髓鞘性脑病##脑血管供血不足	2
胰腺结石术后	胰结石##胰腺术后	2
慢性心衰急性加重期心功能Ⅳ期	心功能IV级(NYHA分级)##慢性心力衰竭	2
盆腔淋巴结继发癌	盆腔淋巴结继发恶性肿瘤##继发性癌	2
颅脑外伤性意识障碍后遗症期	头部损伤##意识障碍	2
右手经桡骨茎突月骨周围脱位正中神经卡压	腕舟骨月骨周围脱位##正中神经卡压综合征	2
唇部白斑颊扁平苔藓	口腔粘膜白斑病##口腔扁平苔癣	2
膝OA腰OA	膝骨关节病##腰椎退行性病变	2
乳腺恶性肿瘤治疗后的随诊检查	乳腺恶性肿瘤##恶性肿瘤其他治疗后的随诊检查	2
低白蛋白血症持续透析状态	低蛋白血症##肾脏透析状态	2
左肺癌全身转移综合治疗后	左肺恶性肿瘤##广泛转移性肿瘤	2
右下肺原位腺癌	右肺下叶恶性肿瘤##原位腺癌	2
外耳道股瘤	骨软骨瘤##耳部肿瘤	2
冠心病(三支病变)	未特指的心血管疾病##冠状动脉粥样硬化性心脏病	2
纵膈肺门占位	胸腔占位性病变##肺占位性病变	2
糖尿病肾病;反流性食管炎	糖尿病性肾病##反流性食管炎	2
2型糖尿病合并2型糖尿病性周围神经病变	2型糖尿病##2型糖尿病性周围神经病	2
肺特指疾患双肺下叶斑片影	肺部阴影##肺病	2
贲门低分化腺癌	贲门恶性肿瘤##腺癌	2
情绪障碍脑白质脱髓鞘	脱髓鞘性白质脑病##心境[情感]障碍	2
增生期样子宫内膜伴息肉	子宫内膜增生##子宫息肉	2
胃角癌,	胃恶性肿瘤##癌	2
腕和手多处损伤(分类S60-S68的损伤)	腕部损伤##手部损伤	2
肥厚性心肌病(扩张型相)	扩张性心肌病[充血性心肌病]##肥厚性心肌病	2
十二指肠乳头低级别绒毛状管状腺瘤	十二指肠良性肿瘤##管状绒毛状腺瘤	2
女性乳腺癌	乳腺恶性肿瘤##癌	2
右足，左小腿骨折复查	足骨折,未特指##小腿骨折	2
左鼻窦鼻腔新生物	鼻窦息肉##鼻腔息肉	2
冠心病—心律失常	冠状动脉粥样硬化性心脏病##心律失常	2
结核性胸膜炎并胸腔积液	结核性胸膜炎##胸腔积液	2
脂肪酶升高原因待查胰腺炎	高脂肪酶血症##胰腺炎	2
右上腭鳞癌	腭恶性肿瘤##鳞状细胞癌	2
左颈动脉硬化性狭窄	颈动脉硬化##颈动脉狭窄	2
下肢挫伤上肢挫伤	上肢损伤##下肢未特指的损伤,水平未特指	2
右乳外上局限性腺体增厚明显Ca待排	乳腺恶性肿瘤##癌	2
子宫粘膜下平滑肌瘤	子宫粘膜下平滑肌瘤##子宫平滑肌瘤	2
右小腿蜂蜇伤	蜂螫伤##小腿损伤	2
右侧胫前动脉中下段左侧胫后动脉不全闭塞	胫前动脉闭塞##胫后动脉闭塞	2
右眼黄斑劈裂左眼高眼压	视网膜劈裂症##高眼压症	2
耳聋病;耵聍栓塞	耳聋##耵聍栓塞	2
右输尿管上段结石并积水	输尿管结石##输尿管积水	2
周围神经病慢性格林巴雷急性发作	吉兰-巴雷综合征##多发性神经病[多发性神经炎/周围神经炎]	2
双踝跌伤	踝部损伤##跌倒	2
雷诺病4右足背动脉闭塞	雷诺综合征##足部动脉闭塞	2
腰背劳损	腰部劳损##背部劳损	2
失眠,静脉曲张,行动不便	失眠##静脉曲张	2
急性弥漫性血管内凝血障碍	凝血功能障碍##弥散性血管内凝血	2
左眼上睑急性睑腺炎、急性化脓性结膜炎	睑腺炎[麦粒肿]##急性结膜炎	2
肝内多发占位与肝硬化	肝硬化##肝占位性病变	2
滑膜炎左膝滑膜皱襞综合症	滑膜炎##膝关节滑膜皱襞综合征	2
恶性肿瘤自体造血干细胞移植治疗	恶性肿瘤##自体造血干细胞移植状态	2
颈髓病变脊髓亚急性联合变性可能性大	亚急性脊髓联合变性病##脊髓病	2
特指泌尿系疾病阴茎扭转	泌尿系统其他特指的疾患##阴茎未特指的疾患	2
1、胸下段食管鳞癌;	食管胸下段恶性肿瘤##鳞状细胞癌	2
多发性硬膜下硬膜外血肿	硬膜下血肿##硬膜外血肿	2
前降支中度狭窄伴心肌桥形成	冠状动脉肌桥##冠状动脉狭窄	2
结肠管状腺瘤伴低级别上皮内瘤变	结肠良性肿瘤##管状腺瘤	2
左膝重度外翻右膝重度内翻	膝外翻##膝内翻	2
乳头增大溢液	乳头溢液##乳头肥大	2
宫颈恶性肿瘤第一次化疗	子宫颈恶性肿瘤##化学治疗	2
右乳导管内乳头状瘤可能	导管内乳头状瘤##乳腺良性肿瘤	2
右肾透明癌	肾恶性肿瘤##透明细胞癌	2
右乳恶性肿瘤联合治疗后的随诊检查	乳腺恶性肿瘤##恶性肿瘤联合治疗后的随诊检查	2
右肾囊肿内伴结石	肾结石##肾囊肿	2
右颊粘膜舌尖及下唇扁平苔藓	口腔扁平苔癣##舌扁平苔癣	2
腺纤维瘤乳腺	腺纤维瘤##乳腺良性肿瘤	2
腰痛,腰椎骨性关节炎,行动不便	腰痛##脊柱骨关节病	2
右乳浸润性癌非特殊类型	乳腺恶性肿瘤##癌	2
急性脑梗死右侧额颞顶枕叶多发梗塞	脑梗死##多发性脑梗死	2
腹泻病，支气管肺炎（恢复期）	支气管肺炎[小叶性肺炎]##肺炎恢复期	2
慢性萎缩性胃炎并糜烂	慢性萎缩性胃炎##糜烂性胃炎	2
去势抵抗前列腺癌	前列腺恶性肿瘤##癌	2
鼻窦继发癌	转移性癌##鼻窦继发恶性肿瘤	2
右眼突眼原因待查右侧颈动脉海绵窦瘘待除外	眼球突出##海绵窦动静脉瘘	2
肌瘤；IUD	肌瘤##具有子宫内避孕装置	2
副脾符合副脾伴淤血性肿大	先天性副脾##脾大	2
颅底凹陷症伴不全瘫	先天性颅底凹陷症##不完全性瘫痪	2
包皮过长伴粘连	包皮过长##包皮粘连	2
髓质海绵肾并双肾钙质沉着	先天性海绵肾##钙质沉着症	2
两侧脑室旁脱髓鞘缺血	脱髓鞘性脑病##脑血管供血不足	2
海洛因海绵状白质脑病	海洛因中毒##脑白质病	2
胃窦中-低分化管状腺癌	胃窦恶性肿瘤##管状腺癌	2
传单反复扁桃体发炎	扁桃体炎##传染性单核细胞增多症[腺性热]	2
卵巢恶性混合性上皮肿瘤IIIc期术后	卵巢恶性肿瘤##恶性上皮瘤##卵巢术后	3
右肺上叶腺癌化疗后随诊检查	右肺上叶恶性肿瘤##腺癌##化学治疗	3
手术后状态(右颞顶部螺旋腺瘤切除术后)	颞部良性肿瘤##腺瘤##其他特指的手术后状态	3
横结肠管状腺瘤直乙交界管状腺瘤	直肠乙状结肠连接部良性肿瘤##横结肠良性肿瘤##管状腺瘤	3
冠心病陈旧性心梗？;脑梗塞	冠状动脉粥样硬化性心脏病##陈旧性心肌梗死##脑梗死	3
乙状结肠管状腺癌维持性化学治疗	乙状结肠恶性肿瘤##管状腺癌##恶性肿瘤维持性化学治疗	3
右乳头乳晕Paget's病	乳房佩吉特病##乳晕恶性肿瘤##乳头恶性肿瘤	3
降结肠粘液腺癌术后	降结肠恶性肿瘤##粘液腺癌##结肠术后	3
G2P1孕36+1周待产LOA,胎膜早破，疤痕子宫	孕36周##胎膜早破##瘢痕子宫	3
胃食管结合部癌综合治疗后吻合口复发	食管胃连接部恶性肿瘤##癌##恶性肿瘤复发	3
乳腺癌晚期复发	乳腺恶性肿瘤##癌##恶性肿瘤复发	3
术后伴胸壁、纵隔、腹膜后等多发淋巴结转移（T1bN3M1a IV期）	胸壁淋巴结继发恶性肿瘤##纵隔淋巴结继发恶性肿瘤##腹膜后淋巴结继发恶性肿瘤	3
左足撕裂伤，左大腿挫裂伤	足部损伤##下肢撕裂伤##大腿损伤	3
面部及左前臂蜂蜇伤	蜂螫伤##面部损伤##前臂损伤	3
高血压冠心病阴道炎	高血压##冠状动脉粥样硬化性心脏病##阴道炎	3
卵巢癌 第七次化疗后	卵巢恶性肿瘤##癌##化学治疗	3
头面部外伤-头外伤后反应左第八肋骨骨折	头部损伤##面部损伤##肋骨骨折	3
食管下段癌化疗后	食管下三分之一的恶性肿瘤##化学治疗##癌	3
痛经,闭经,盆腔炎	痛经##闭经##女性盆腔炎	3
食管胸中下段鳞癌 家属咨询	食管胸中段恶性肿瘤##食管胸下段恶性肿瘤##鳞状细胞癌	3
坠落伤右肱骨开放性骨折伴脱位	自高处坠落##上肢开放性骨折##肱骨骨折	3
右乳小叶增生伴纤维腺瘤	乳腺良性肿瘤##纤维腺瘤##乳腺增生	3
低钙镁氯血症	低钙血症##低镁血症##低氯血症	3
左侧肢体无力待查颈腰椎病	偏侧肢体无力##颈椎病##腰椎病	3
左乳肿块性质待查:癌	乳房肿物##乳腺恶性肿瘤##癌	3
结肠肝曲结肠脾区管状腺瘤部分腺体较增生	管状腺瘤##结肠肝曲良性肿瘤##结肠脾曲良性肿瘤	3
急性脑梗死；高血压病；心肌缺血	脑梗死##高血压##心肌供血不足	3
慢性阻塞性肺疾病急性加重期气管插管术后II型呼吸衰竭	慢性阻塞性肺疾病急性加重##气管术后##Ⅱ型呼吸衰竭	3
左甲癌术后	甲状腺恶性肿瘤##癌##甲状腺术后	3
右肺小细胞癌化疗	右肺恶性肿瘤##小细胞癌##化学治疗	3
宫颈中分化腺癌IIB期术后2程化疗后	子宫颈恶性肿瘤##腺癌##恶性肿瘤术后化疗	3
颈椎病颈椎间盘突出症颈椎管狭窄症	颈椎病##颈椎间盘突出##颈椎管狭窄	3
右上肺鳞癌术后（pT2N2MO	肺术后##右肺上叶恶性肿瘤##鳞状细胞癌	3
食道癌放疗	食管恶性肿瘤##癌##恶性肿瘤放疗	3
双下肢水肿待查：心功能不齐高心病？	下肢水肿##心功能不全##高血压性心脏病	3
乳腺癌，风心病（慢病长期用药）	乳腺恶性肿瘤##癌##风湿性心脏病	3
胆囊绒毛管状腺瘤伴灶性重度异型增生?	管状绒毛状腺瘤##胆囊良性肿瘤##胆囊不典型增生	3
口服结核药物呕吐、食欲差	药物不良反应##呕吐##食欲不振	3
右乳浸润性导管癌生物治疗	乳腺恶性肿瘤##浸润性导管癌##恶性肿瘤生物治疗	3
肾上腺肿物腺瘤可能	肾上腺肿物##腺瘤##肾上腺良性肿瘤	3
甲状腺腺瘤切除术后	甲状腺良性肿瘤##腺瘤##甲状腺术后	3
结肠癌并肠梗阻	结肠恶性肿瘤##肠梗阻##癌	3
左颊粘膜鳞癌术后 T3N1M0	颊黏膜恶性肿瘤##鳞状细胞癌##淋巴结继发恶性肿瘤	3
右肺上叶大细胞癌中医治疗	右肺上叶恶性肿瘤##大细胞癌##恶性肿瘤中医治疗	3
右上腭及右扁桃体经典霍奇金淋巴瘤化疗后	经典型霍奇金淋巴瘤##扁桃体淋巴瘤##化学治疗	3
肝郁失眠毛囊炎咳嗽内火	失眠##毛囊炎##咳嗽	3
上消化道出血(食道胃底静脉曲张)	上消化道出血##食管静脉曲张##胃底静脉曲张	3
肾上腺神经节母细胞瘤术后复发（IV期）	肾上腺恶性肿瘤##神经节神经母细胞瘤##恶性肿瘤复发	3
1、(R93.203)肝占位性病变2、慢性乙型肝炎3、(K74.608)肝炎后肝硬化失代偿期	肝占位性病变##慢性乙型病毒性肝炎##肝炎肝硬化	3
结肠癌术后 第二次化疗后	结肠恶性肿瘤##癌##恶性肿瘤术后化疗	3
低钾低钠底钙血症	低钾血症##低钠血症##低钙血症	3
肝总管Ca肝内占位	肝外胆管恶性肿瘤##肝占位性病变##癌	3
颈34融合颈45不稳脊柱轻度侧弯	先天性颈椎体融合##颈椎不稳定##脊柱侧弯	3
右卵巢无性细胞瘤术剥除后	无性细胞瘤##卵巢术后##卵巢恶性肿瘤	3
卵巢癌肿瘤细胞减灭术术后	卵巢恶性肿瘤##癌##卵巢术后	3
右肺癌放化疗后	右肺恶性肿瘤##化学治疗##恶性肿瘤放疗	3
肾母细胞瘤化疗	肾恶性肿瘤##肾母细胞瘤##化学治疗	3
糖尿病低血糖;糖尿病视网膜病变;高脂血症	糖尿病性低血糖症##糖尿病性视网膜病变##高脂血症	3
乙状结肠管状腺癌术后	乙状结肠恶性肿瘤##管状腺癌##结肠术后	3
孕29+周腹痛：先兆流产？	孕29周##腹痛##先兆流产	3
原发性肝癌化疗	肝恶性肿瘤##化学治疗##癌	3
带状疱疹？虫咬性皮炎？	带状疱疹##昆虫性皮炎##昆虫咬伤	3
盆腔未分化肉瘤术后	盆腔恶性肿瘤##未分化肉瘤##盆腔术后	3
左肺腺癌（T2N3M1B IV期）	左肺恶性肿瘤##腺癌##淋巴结继发恶性肿瘤	3
横结肠乙状结肠管状腺瘤建议定期复查	乙状结肠良性肿瘤##横结肠良性肿瘤##管状腺瘤	3
双侧乳腺腺瘤术后	乳腺良性肿瘤##腺瘤##乳腺术后	3
RA糖尿病胃炎	类风湿性关节炎##糖尿病##胃炎	3
右肺小细胞癌维持性化学治疗	右肺恶性肿瘤##小细胞癌##恶性肿瘤维持性化学治疗	3
颈部、锁骨上、腹腔淋巴结转移	颈部淋巴结继发恶性肿瘤##锁骨上淋巴结继发恶性肿瘤##腹腔淋巴结继发恶性肿瘤	3
肝占位病变,考虑肝癌	肝恶性肿瘤##癌##肝占位性病变	3
牙周炎A67牙本质过敏C2-D1楔缺	牙本质过敏症##牙齿楔状缺损##牙周炎	3
宫颈鳞癌IIA2期化疗后	子宫颈恶性肿瘤##鳞状细胞癌##化学治疗	3
右侧后腹膜神经母细胞瘤化疗后	神经母细胞瘤##腹膜恶性肿瘤##化学治疗	3
右足第4跖骨右足跟骨及舟骨撕脱性骨折	跖骨骨折##跟骨骨折##足舟骨骨折	3
子宫出血，系统性红斑狼疮，中度贫血	异常子宫出血##系统性红斑狼疮##中度贫血	3
宫颈鳞状细胞癌IIA1期术后	子宫颈恶性肿瘤##鳞状细胞癌##宫颈术后	3
左乳肿块癌	乳房肿物##乳腺恶性肿瘤##癌	3
反应性精神症病脑精分情感障碍	反应性精神病##精神分裂症##双相情感障碍	3
原发性肝癌介入后##门静脉癌栓形成	肝恶性肿瘤##门静脉瘤栓##癌	3
左卵巢子宫内膜样癌化疗后	子宫内膜样癌##卵巢恶性肿瘤##化学治疗	3
急性脑梗塞桥脑右颞急性腔隙性梗塞	脑梗死##多发性脑梗死##腔隙性脑梗死	3
左舌叶病灶性质待查：肺炎可能，肺癌待排	肺炎##肺恶性肿瘤##癌	3
双肺多发转移骨转移不除外	肺继发恶性肿瘤##骨继发恶性肿瘤##转移性肿瘤	3
头痛.头晕.高血压	头痛##头晕##高血压	3
骨转移放疗后LuminalBHER2阴性	骨继发恶性肿瘤##转移性肿瘤##恶性肿瘤放疗	3
乙状结肠癌术后辅助治疗，复查	结肠术后##乙状结肠恶性肿瘤##癌	3
卵巢癌化疗后骨髓抑制	卵巢恶性肿瘤##化疗后骨髓抑制##癌	3
咽炎扁桃体炎鼻炎	扁桃体炎##咽炎##鼻炎	3
喉咽癌化疗后	喉咽恶性肿瘤##癌##化学治疗	3
食管胃交界癌术后,纳差	食管胃连接部恶性肿瘤##癌##食欲不振	3
右卵巢子宫内膜样腺癌维持性化学治疗	卵巢恶性肿瘤##恶性肿瘤维持性化学治疗##子宫内膜样腺癌	3
左足透明细胞肉瘤反复复发术后	足部恶性肿瘤##透明细胞肉瘤##恶性肿瘤复发	3
原发性甲状腺功能减退症（甲状腺囊肿术后甲减）	原发性甲状腺功能减退##甲状腺囊肿##甲状腺功能减退	3
右腹膜后神经母细胞瘤Ⅳ期术后化疗（高危组）	腹膜后恶性肿瘤##神经母细胞瘤##恶性肿瘤术后化疗	3
子宫内膜癌Ⅱ期术后Ⅱ期 T2N0M0	子宫术后##子宫内膜恶性肿瘤##癌	3
宫颈癌化疗	子宫颈恶性肿瘤##化学治疗##癌	3
冠心病高血压病高脂血症	冠状动脉粥样硬化性心脏病##高血压##高脂血症	3
右乳纤维囊性乳腺病并纤维腺瘤	乳腺良性肿瘤##纤维腺瘤##乳房纤维囊性乳腺病	3
右上肢及胸腹部锯割伤	上肢开放性损伤##胸部开放性损伤##腹部开放性损伤	3
肝脏肿瘤：肝母细胞瘤？	肝恶性肿瘤##肝母细胞瘤##肝母细胞瘤	3
骨质疏松，白细胞减少，抑郁症	骨质疏松##白细胞减少##抑郁症	3
无精症输精管梗阻精液淤积症	无精子症##输精管梗阻##附睾精索精子淤积症	3
卵巢癌化疗后	卵巢恶性肿瘤##癌##化学治疗	3
胃角低分化腺癌术后	胃恶性肿瘤##腺癌##胃术后	3
颈7-胸3椎体病变伴不全瘫	颈椎病##不完全性瘫痪##脊椎病	3
糖尿病性神经炎(反复发作低血糖)	糖尿病##神经炎##低血糖	3
1脑动脉硬化，2原发性高血压2级高危组32型糖尿病并周围神经病4前列腺增生5T2,3水平椎管后份硬脊膜外病变原因	前列腺增生##2型糖尿病性周围神经病##脑血管硬化	3
特指胎盘疾病胎盘低置状态羊水减少	未特指的胎盘疾患##低置胎盘##妊娠合并羊水过少	3
慢性胃炎伴糜烂.失眠	慢性胃炎##糜烂性胃炎##失眠	3
纵膈、左肺门淋巴结转移胸膜转移不除外	肺门淋巴结继发恶性肿瘤##纵隔淋巴结继发恶性肿瘤##转移性肿瘤	3
冠心病,心绞痛型+缺血性心肌病	心绞痛##缺血性心肌病##冠状动脉粥样硬化性心脏病	3
肺部感染支气管扩张咯血	肺部感染##支气管扩张症##咯血	3
殴打致头部左膝部受伤	被别人殴打、踢、拧、咬或抓伤##头部损伤##下肢未特指的损伤,水平未特指	3
子宫绒癌化疗	子宫恶性肿瘤##绒毛膜癌##化学治疗	3
右甲癌不全术后	甲状腺恶性肿瘤##癌##甲状腺术后	3
左下叶开口非小细胞Ca考虑鳞状细胞Ca	左肺下叶恶性肿瘤##非小细胞癌##鳞状细胞癌	3
胃窦低分化腺癌术后（T4N3M1，Ⅳ期）	胃术后##胃窦恶性肿瘤##腺癌	3
外阴痒外阴炎霉菌阴道炎	外阴瘙痒(症)##外阴炎##真菌性阴道炎	3
肺癌癌痛	肺恶性肿瘤##癌##癌性疼痛	3
发热待查：化扁，肺炎？	发热##急性化脓性扁桃体炎##肺炎	3
盲肠1升结肠2管状腺瘤伴低级别上皮内瘤变	盲肠良性肿瘤##升结肠良性肿瘤##管状腺瘤	3
全身淋巴结放化疗后	恶性肿瘤放疗##化学治疗##未特指的淋巴结恶性肿瘤	3
CA199CA242CEA增高原因未明	CA199升高##CEA升高##肿瘤标记物升高	3
电弧火焰烧伤双下肢	下肢烧伤##火焰烧伤##电流引起烧伤	3
右下肺鳞术后（pT4N2M0	右肺下叶恶性肿瘤##肺术后##鳞状细胞癌	3
重型颅脑损伤术后2颅内感染	颅内损伤##脑术后##颅内感染	3
左肺上叶肺大泡破裂并气胸左侧胸壁引流术后	肺大疱破裂##气胸##胸腔闭式引流术后	3
喉咽癌 T4N2M0 IV期	喉咽恶性肿瘤##癌##淋巴结继发恶性肿瘤	3
诺卡菌病肺皮肤骨	肺诺卡菌病##皮肤诺卡菌病##其他形式的诺卡菌病	3
右锁骨上淋巴结继发恶性肿瘤放化疗后	锁骨上淋巴结继发恶性肿瘤##恶性肿瘤放疗##化学治疗	3
左股骨骨质破坏区姑息性放疗后	骨质破坏##姑息医疗##放射治疗	3
G2P1孕40+2周ROA平产、地中海贫血、中度贫血	头位顺产##地中海贫血##中度贫血	3
尿路感染，肾炎？左肾静脉受压？	泌尿系感染##肾炎##左肾静脉压迫综合征[胡桃夹现象]	3
慢性鼻-鼻窦炎伴鼻息肉；高血压病	慢性鼻窦炎##鼻息肉##高血压	3
胃体低分化腺癌IV期 肠型 HER2(-) 化疗	胃体恶性肿瘤##腺癌##化学治疗	3
双乳CA化疗	乳房恶性肿瘤##化学治疗##癌	3
T12L1后缩性骨折	胸椎压缩性骨折##腰椎骨折L1##腰椎压缩性骨折	3
胃底隆起病变CG糜烂	糜烂性胃炎##慢性胃炎##胃和十二指肠未特指的疾病	3
冠心合并肺心病-心功能3级	肺源性心脏病##冠状动脉粥样硬化性心脏病##心功能III级(NYHA分级)	3
右颞顶枕及基底节区多发梗塞	脑梗死##多发性脑梗死##基底节脑梗死	3
血尿蛋白尿查因IGA肾病	IgA肾病##蛋白尿##血尿	3
癌细胞侵入胰腺组织并侵及十二指肠粘膜	癌##胰腺继发恶性肿瘤##十二指肠继发恶性肿瘤	3
肺恶性肿瘤;冠状动脉供血不足;高脂血症;肝肾阴虚	肺恶性肿瘤##冠状动脉供血不足##高脂血症	3
右拇指甲床示指皮肤撕脱缺损	拇指开放性损伤伴指甲损伤##手指开放性损伤##皮肤缺损	3
右肺上叶大细胞癌免疫治疗	右肺上叶恶性肿瘤##大细胞癌##恶性肿瘤免疫治疗	3
腸炎，上呼吸道感染，胃溃	肠炎##上呼吸道感染##胃溃疡	3
多处皮肤擦挫伤、多处软组织伤	多处皮肤浅表擦伤##多处皮肤浅表挫伤##多处损伤	3
左上肺占位:癌	肺占位性病变##左肺上叶恶性肿瘤##癌	3
多发性淋巴结肿大（淋巴瘤可能性大）	淋巴结肿大##淋巴瘤##淋巴瘤	3
多发骨质破坏原因代谢性骨病氟骨病肿瘤	骨质破坏##氟骨症##性质未特指的肿瘤	3
异位肾伴旋转不良伴巨输尿管右侧	肾异位##先天性肾旋转不良##先天性巨输尿管	3
左乳腺癌（ST2N1MO）化疗	乳腺恶性肿瘤##癌##化学治疗	3
右上肺结节:肺癌	肺占位性病变##右肺上叶恶性肿瘤##癌	3
额颞顶叶硬膜下积液低铁低锌	硬脑膜下积液##铁缺乏##锌缺乏	3
格林巴利综合征？高位脊髓病变？低钾？	吉兰-巴雷综合征##低钾血症##脊髓病	3
肝癌射频消融治疗后	肝恶性肿瘤##癌##射频消融术后	3
1宫颈鳞状细胞CAⅡb期 2高血压病	子宫颈恶性肿瘤##鳞状细胞癌##高血压	3
结肠肝曲癌并不全梗阻	结肠肝曲恶性肿瘤##不完全性肠梗阻##癌	3
双下肢无力原因一氧化碳中毒性周围神经病	肢体无力##一氧化碳中毒后遗症##多发性神经病[多发性神经炎/周围神经炎]	3
右肾癌术后，免疫力降低,左肾多发囊肿，右肾囊肿	肾恶性肿瘤##肾囊肿##癌	3
毛支炎（恢复期），哮喘？	细支气管炎##恢复期##支气管哮喘	3
卵巢癌细胞减灭术后	卵巢恶性肿瘤##癌##卵巢术后	3
右乳浸润性导管癌术后化疗(pT	浸润性导管癌##乳腺恶性肿瘤##恶性肿瘤术后化疗	3
左上肢背部玻璃割伤	上肢开放性损伤##背部开放性损伤##玻璃割伤	3
退行性瓣膜病二尖瓣三尖瓣主动脉瓣?	二尖瓣退行性变##三尖瓣病##退行性主动脉瓣疾患	3
急性脑梗死右侧颞枕叶出血性梗死	脑梗死##多发性脑梗死##出血性脑梗死	3
双乳纤维囊性乳腺病合并导管内乳头状瘤	乳腺良性肿瘤##乳房纤维囊性乳腺病##导管内乳头状瘤	3
喉癌全程放疗后	喉恶性肿瘤##癌##恶性肿瘤放疗	3
皮炎腰腿痛	皮炎##下肢疼痛##腰痛	3
胃体低分化腺癌伴印戒细胞癌IV期	胃体恶性肿瘤##腺癌##印戒细胞癌	3
腹痛; 肠癌术后	腹痛##胃肠道恶性肿瘤##癌	3
卵巢癌,尿频？	卵巢恶性肿瘤##癌##尿频	3
颈髓脱髓鞘病变焦虑合并抑郁	脱髓鞘病##抑郁状态##焦虑状态	3
右肺鳞癌维持性化学治疗	右肺恶性肿瘤##鳞状细胞癌##恶性肿瘤维持性化学治疗	3
直肠乙状结肠双原发癌	直肠恶性肿瘤##乙状结肠恶性肿瘤##癌	3
脑卒中高血压高脂血症	脑卒中##高血压##高脂血症	3
结肠癌癌痛	结肠恶性肿瘤##癌##癌性疼痛	3
乳腺癌化疗低血象	乳腺恶性肿瘤##癌##化学治疗	3
糖尿病糖尿病肾病糖尿病性视网膜病变	糖尿病##糖尿病性肾病##糖尿病性视网膜病变	3
晕厥待查：心源性？癫痫？单纯性？	晕厥##癫痫##心源性晕厥	3
肺占位，前纵膈占位，重症肌无力	肺占位性病变##胸腔占位性病变##重症肌无力	3
结肠癌,右肺上叶小结节	结肠恶性肿瘤##肺占位性病变##癌	3
头颈部刀砍伤	头部开放性损伤##颈部开放性损伤##刀砍伤加害	3
急性胆囊炎胆囊结石;肠梗阻;	急性胆囊炎##胆囊结石##肠梗阻	3
横结肠癌术后pT3N2M0IIIC期pMMR	结肠术后##横结肠恶性肿瘤##癌	3
新生儿胎粪吸入综合征先心病心衰缺氧缺血	新生儿胎粪吸入综合征##胎儿先天性心脏病##新生儿心力衰竭	3
前列腺滤泡腺癌放疗后	前列腺恶性肿瘤##腺癌##恶性肿瘤放疗	3
特指胎盘疾病低置胎盘胎盘浅植入	其他的胎盘疾患##低置胎盘##胎盘植入不伴出血	3
急性胆囊炎胆囊结石急性胃炎	急性胆囊炎##胆囊结石##急性胃炎	3
肝占位性病变:肝癌	肝恶性肿瘤##癌##肝占位性病变	3
软组织肉瘤肠系膜脂肪肉瘤	脂肪肉瘤##软组织肉瘤##肠系膜恶性肿瘤	3
化扁；溃疡性口腔炎；支气管炎	急性化脓性扁桃体炎##溃疡性口炎##支气管炎	3
直肠乙状结肠管状腺瘤建议定期随诊复查	直肠良性肿瘤##乙状结肠良性肿瘤##管状腺瘤	3
电解质功能紊乱低钾低钙	电解质紊乱##低钾血症##低钙血症	3
卵巢高级别浆液性乳头状癌IIIc期术后	卵巢恶性肿瘤##浆液性癌##卵巢术后	3
乳腺Caa化疗	乳腺恶性肿瘤##癌##化学治疗	3
右侧舌根部鳞状细胞癌伴颈部淋巴结转移术后（T2N1M0）	舌恶性肿瘤##鳞状细胞癌##颈部淋巴结继发恶性肿瘤	3
甲状腺癌,卵巢囊肿？	甲状腺恶性肿瘤##卵巢囊肿##癌	3
直肠癌伴不全肠梗阻	直肠恶性肿瘤##不完全性肠梗阻##癌	3
冠心病心绞痛型缺血性心肌病	冠状动脉粥样硬化性心脏病##心绞痛##缺血性心肌病	3
胃癌术后化疗(pT4aN1M0	胃恶性肿瘤##恶性肿瘤术后化疗##癌	3
冠心病急性心肌梗死肾功能不全	冠状动脉粥样硬化性心脏病##急性心肌梗死##肾功能不全	3
多发性骨髓瘤(IGG KAPPA型)ISS分期I期 D-S分期IIIA期	多发性骨髓瘤(IgGк型)##多发性骨髓瘤(ISS分期I期)##多发性骨髓瘤(DS分期III期)	3
Z足癣感染药疹	足癣##药物性皮炎[药疹]##足感染	3
乙状结肠中分化腺癌切除术	乙状结肠恶性肿瘤##腺癌##结肠术后	3
右乳癌术前新辅助化疗后	乳腺恶性肿瘤##化学治疗##癌	3
月经不调HPV阳性宫颈CINI	月经紊乱##宫颈人乳头瘤病毒感染##子宫颈上皮瘤样病变[CIN]I级	3
支气管肺炎(恢复期)，感染性腹泻腹泻病	支气管肺炎[小叶性肺炎]##恢复期##感染性腹泻	3
口咽癌姑息	口咽恶性肿瘤##姑息医疗##癌	3
甲状腺乳头状微小癌术后	乳头状微小癌##甲状腺恶性肿瘤##甲状腺术后	3
喉癌治疗后的随诊检查	喉恶性肿瘤##癌##恶性肿瘤治疗后的随诊检查	3
头晕。颈椎病。椎动脉供血不全	头晕##颈椎病##椎-基底动脉供血不全	3
S2、T8及左第8后肋骨转移瘤	脊柱继发恶性肿瘤##肋骨继发恶性肿瘤##转移性肿瘤	3
左髋痛胸腰畸形;骨质疏松	下肢疼痛##骨质疏松##脊柱畸形	3
左肘左膝左足部工伤	上肢损伤##足部损伤##下肢未特指的损伤,水平未特指	3
肾癌 尿路感染	肾恶性肿瘤##泌尿系感染##癌	3
右肺鳞癌中医治疗	右肺恶性肿瘤##鳞状细胞癌##恶性肿瘤中医治疗	3
右肺中叶腺癌治疗后的随诊检查	右肺中叶恶性肿瘤##腺癌##恶性肿瘤其他治疗后的随诊检查	3
结肠低分化腺癌根治术后pT4NxMx	结肠恶性肿瘤##腺癌##结肠术后	3
浮肿血瘀胸痹咳嗽咽痛	咳嗽##咽痛##水肿	3
直肠息肉-管状腺瘤伴低级别上皮内瘤变	直肠良性肿瘤##直肠息肉##管状腺瘤	3
肝MT术后，淋巴结转移	肝恶性肿瘤##肝术后##淋巴结继发恶性肿瘤	3
胃癌化疗后	胃恶性肿瘤##化学治疗##癌	3
宫颈中分化鳞癌Ⅱb期放疗后	子宫颈恶性肿瘤##鳞状细胞癌##恶性肿瘤放疗	3
胆管癌：重度贫血	胆管恶性肿瘤##胆管癌##重度贫血	3
左乳肿物,乳腺癌	乳房肿物##乳腺恶性肿瘤##癌	3
结肠癌术后pT3NIb	结肠术后##结肠恶性肿瘤##癌	3
胃贲门中低分化腺癌IIIC期术后(pT4bN3aM0)	贲门术后##贲门恶性肿瘤##腺癌	3
左肺SCLC局限期3程化疗后	肺恶性肿瘤##小细胞癌##化学治疗	3
右肺占位-肺癌可能性大	肺占位性病变##右肺恶性肿瘤##癌	3
右肺癌靶向治疗	右肺恶性肿瘤##恶性肿瘤靶向治疗##癌	3
急性淋巴细胞白血病(急性B淋巴细胞白血病)	急性淋巴细胞白血病##急性淋巴细胞白血病##B细胞急性淋巴细胞白血病	3
右乳肿物纤维腺瘤	乳房肿物##纤维腺瘤##乳腺良性肿瘤	3
烧伤后颈部瘢痕挛缩畸形	颈部烧伤##颈部瘢痕##瘢痕挛缩	3
胃窦管状腺癌根治术后(pT4N	胃术后##胃窦恶性肿瘤##管状腺癌	3
左乳肿物:左乳癌	乳房肿物##乳腺恶性肿瘤##癌	3
皮疹待查：小儿康疹？肠蛔虫症？	皮疹##白色糠疹##肠蛔虫病	3
部分小肠缺血坏死回肠部分盲肠切除术	缺血性肠坏死##回肠术后##盲肠术后	3
鼻咽癌根治性放射治疗	鼻咽恶性肿瘤##癌##恶性肿瘤放疗	3
右乳腺癌中医治疗	乳腺恶性肿瘤##恶性肿瘤中医治疗##癌	3
冠心病、高血压、贫血？	冠状动脉粥样硬化性心脏病##高血压##贫血	3
慢性全胃炎伴糜烂，糜烂性十二指肠炎	慢性胃炎##糜烂性胃炎##十二指肠炎	3
多发性骨髓瘤(LAM轻链型),D-S分期IIIB期,ISS分期III期	多发性骨髓瘤(轻链λ型)##多发性骨髓瘤(ISS分期III期)##多发性骨髓瘤(DS分期III期B组)	3
腹腔粘液腺癌化疗	腹部恶性肿瘤##粘液腺癌##化学治疗	3
（肝S6）肝细胞癌II级，可见脉管癌栓	肝细胞癌##肝细胞癌##肿瘤栓子	3
健康查体; 肺癌待查	健康查体##肺恶性肿瘤##癌	3
右乳浸润性导管癌ⅡB期(pT2N1M0)改良根治术	乳腺术后##乳腺恶性肿瘤##浸润性导管癌	3
贫血原因待查 1.营养性贫血？ 2.骨髓增生异	贫血##营养性贫血##骨髓增生异常性贫血	3
升结肠腺癌维持性化学治疗	升结肠恶性肿瘤##腺癌##恶性肿瘤维持性化学治疗	3
食管中段癌放化疗后	食管中三分之一的恶性肿瘤##癌##恶性肿瘤放疗	3
胃癌维持性化疗	胃恶性肿瘤##恶性肿瘤维持性化学治疗##癌	3
糖尿病高血压糖尿病神经病变	高血压##糖尿病##糖尿病伴神经系统并发症	3
肺转移；腹腔淋巴结转移	肺继发恶性肿瘤##腹腔淋巴结继发恶性肿瘤##转移性肿瘤	3
肾上腺腺瘤 儿茶酚胺增多症	肾上腺良性肿瘤##腺瘤##儿茶酚胺分泌过多	3
高血压性心脏心脏增大心功能III-IV级	心功能III级(NYHA分级)##心功能IV级(NYHA分级)##慢性心力衰竭	3
脑梗死,记忆力减退,高脂血症,骨质疏松	脑梗死##高脂血症##骨质疏松	3
右上肺结节：炎症？MT？	肺占位性病变##肺炎##肺恶性肿瘤	3
食管癌''高血压	食管恶性肿瘤##癌##高血压	3
直肠腺癌根治术后pT2N0M0	直肠术后##直肠恶性肿瘤##腺癌	3
颈部前胸部猫抓伤	被其他哺乳动物咬伤或抓伤,在未特指场所##颈部开放性损伤##胸部开放性损伤	3
升结肠符合管状腺瘤乙状结肠管状腺瘤	乙状结肠良性肿瘤##升结肠良性肿瘤##管状腺瘤	3
膈肌痉挛？胃炎？反流性食管炎？	痉挛##胃炎##反流性食管炎	3
胃十二指肠多发溃疡伴幽门梗阻	胃溃疡##十二指肠溃疡##幽门梗阻	3
宫颈癌IIIb期化疗后	子宫颈恶性肿瘤##化学治疗##癌	3
喉癌放疗	喉恶性肿瘤##癌##恶性肿瘤放疗	3
右肾输尿管膀胱部分切除	肾术后##输尿管术后##膀胱术后	3
右侧慢性化脓性中耳乳突炎（骨疡型）	慢性化脓性中耳炎##慢性乳突炎##乳突骨疡	3
局灶-继发全身发作枕叶发作	枕叶性癫痫##癫痫部分性发作##癫痫大发作[全身强直-阵挛性发作]	3
食管胃结合部中分化腺癌 肠型,腹腔淋巴结转移	食管胃连接部恶性肿瘤##腺癌##腹腔淋巴结继发恶性肿瘤	3
带环出血冠心病	放置子宫内避孕装置##出血##冠状动脉粥样硬化性心脏病	3
心衰红皮病嗜酸性粒细胞增多症	嗜酸粒细胞增多综合征##红皮病##心力衰竭	3
冠心病\支架术后\心绞痛	冠状动脉粥样硬化性心脏病##冠状动脉支架植入术后状态##心绞痛	3
感染性疾病脑梗后低血糖	感染##脑梗死##低血糖症	3
胰后脾静脉海绵样变肠系膜上静脉海绵样变	脾血管瘤##肠系膜血管瘤##海绵状血管瘤	3
鼻咽癌放疗23次	鼻咽恶性肿瘤##恶性肿瘤放疗##癌	3
左侧股骨外踝前壁内踝后壁撕脱性骨折	内踝骨折##外踝骨折##股骨骨折	3
右手小指神经肌腱血管断裂	腕和手血管损伤##手部肌肉肌腱断裂##手部神经断裂	3
右肺鳞癌 cT4N3M1 Ⅳ期	右肺恶性肿瘤##鳞状细胞癌##淋巴结继发恶性肿瘤	3
纵隔淋巴结放化疗后	恶性肿瘤放疗##化学治疗##未特指的淋巴结恶性肿瘤	3
宫颈乳头状鳞形细胞癌放疗后	子宫颈恶性肿瘤##乳头状鳞状细胞癌##恶性肿瘤放疗	3
冠心病高血压骨关节病	冠状动脉粥样硬化性心脏病##高血压##骨关节病	3
胃窦管状腺瘤伴轻-中度不典型增生Hp-	胃良性肿瘤##管状腺瘤##胃粘膜不典型增生	3
下腹部包块待查；双侧腹股沟疝气术后	腹部肿物##双侧腹股沟疝##腹股沟术后	3
左肺上叶中央型肺癌IV期纵膈淋巴结肿大	左肺上叶恶性肿瘤##癌##纵隔淋巴结肿大	3
心律失常持续性房颤偶发室早	心律失常##持续性心房颤动##室性期前收缩	3
升结肠癌并不全性肠梗阻	升结肠恶性肿瘤##不完全性肠梗阻##癌	3
左乳头溢液:导管内乳头状瘤	导管内乳头状瘤##乳腺良性肿瘤##乳头溢液	3
左侧DDH继发OA双膝OA	先天性髋关节发育不良##双侧膝关节骨性关节病##髋骨关节病	3
左下肺结节:肺癌	肺占位性病变##左肺下叶恶性肿瘤##癌	3
右输尿管癌PT2N0M0术后	输尿管恶性肿瘤##癌##输尿管术后	3
直肠肛门口绒毛管状腺瘤	直肠良性肿瘤##肛门良性肿瘤##管状绒毛状腺瘤	3
冠心病心律失常型;高血压;慢性喘息性支气管炎;高血压性肾病	冠心病心律失常型##高血压##高血压性肾病	3
卵巢高级别浆液性乳头状癌，第三次化疗后	卵巢恶性肿瘤##浆液性表面乳头状癌##化学治疗	3
下咽癌合并胸中段食管癌	下咽恶性肿瘤##食管胸中段恶性肿瘤##癌	3
多发性脑梗塞；脑缺血脱髓鞘；记忆力减退	多发性脑梗死##脑血管供血不足##脱髓鞘性脑病	3
脑干出血，高血压病，冠心病	脑干出血##高血压##冠状动脉粥样硬化性心脏病	3
左髋AVN右膝重度OA伴内翻	单侧膝关节骨性关节病##股骨头缺血性坏死##膝内翻	3
十二指肠恶性肿瘤术后(恶性黑色素瘤)	十二指肠恶性肿瘤##十二指肠术后##恶性黑色素瘤	3
右乳肿物:癌	乳房肿物##乳腺恶性肿瘤##癌	3
冠心病糖尿病关节炎	冠状动脉粥样硬化性心脏病##糖尿病##关节炎	3
右肺结节 肺癌不除外	肺占位性病变##肺恶性肿瘤##癌	3
左足舟状骨跟骨骰骨背侧撕脱性骨折	足舟骨骨折##骰骨骨折##跟骨骨折	3
低锌低铁地贫	铁缺乏##锌缺乏##地中海贫血	3
阴茎癌伴感染	阴茎恶性肿瘤##感染##癌	3
晚期胃癌，长期不能进食	胃恶性肿瘤##进食障碍##癌	3
胆囊癌，高血压	胆囊恶性肿瘤##癌##高血压	3
食管下段小细胞癌维持性化学治疗	食管下三分之一的恶性肿瘤##恶性肿瘤维持性化学治疗##癌	3
癌症化放疗	癌症##恶性肿瘤放疗##化学治疗	3
肝硬化腹水，胸水	肝硬化##腹水##胸腔积液	3
血白细胞升高原因头昏原因双眼浮肿原因	白细胞增多##眼睑水肿##头晕	3
左下肢DVT,高血压，高血脂	下肢深静脉血栓形成##高血压##高脂血症	3
上呼吸道感染;乳腺癌	上呼吸道感染##乳腺恶性肿瘤##癌	3
贲门早CA 胃息肉	贲门恶性肿瘤##癌##胃息肉	3
踝关节腱鞘囊肿，腱鞘炎	踝关节囊肿##腱鞘囊肿##腱鞘炎	3
血尿蛋白尿查因:IGA肾病	血尿##蛋白尿##IgA肾病	3
右侧乳腺癌放疗后	乳腺恶性肿瘤##恶性肿瘤放疗##癌	3
右中指末节开放伤伴指深屈肌腱指神经损伤	手指开放性损伤##指神经损伤##手部肌肉肌腱损伤	3
胃癌伴幽门梗阻	胃恶性肿瘤##幽门梗阻##癌	3
支气管肺炎、轮状病毒肠炎、心肌损害？	支气管肺炎[小叶性肺炎]##轮状病毒性肠炎##心肌损害	3
电弧烧伤面颈	面部烧伤##颈部烧伤##电流引起烧伤	3
腰5椎体病变伴双下肢不全瘫	不完全性瘫痪##截瘫[双下肢瘫痪]##腰椎病	3
右肺小细胞肺癌维持性化学治疗	右肺恶性肿瘤##小细胞癌##恶性肿瘤维持性化学治疗	3
贲门胃体管状腺瘤	管状腺瘤##贲门良性肿瘤##胃良性肿瘤	3
甲状腺乳头状瘤术后	乳头状瘤##甲状腺良性肿瘤##甲状腺术后	3
心累气促血脂高CHD	血脂异常##冠状动脉粥样硬化性心脏病##呼吸短促	3
皮肤瘙痒症，甲减，类风湿性关节炎	瘙痒(症)##甲状腺功能减退##类风湿性关节炎	3
食管胸中段中分化鳞癌（术后）	食管术后##食管胸中段恶性肿瘤##鳞状细胞癌	3
基底节多发腔隙性脑梗死	腔隙性脑梗死##基底节脑梗死##多发性脑梗死	3
双膝重度OA右侧平足伴OA	双侧膝关节骨性关节病##骨关节病##扁平足	3
肝Ca肝硬化乙肝	肝恶性肿瘤##癌##肝硬化	3
盲肠降结肠符合管状腺瘤	盲肠良性肿瘤##降结肠良性肿瘤##管状腺瘤	3
急性脑梗死多发陈旧性脑梗死	脑梗死##陈旧性脑梗死##多发性脑梗死	3
右肾母细胞瘤化疗后	肾恶性肿瘤##肾母细胞瘤##化学治疗	3
乙状结肠癌腹主动脉旁、左髂总血管旁淋巴结转移	乙状结肠恶性肿瘤##癌##淋巴结继发恶性肿瘤	3
肝占位,肝癌	肝恶性肿瘤##癌##肝占位性病变	3
胰腺神经内分泌肿瘤G2术后多发转移	胰腺术后##神经内分泌肿瘤G2##广泛转移性肿瘤	3
直肠活检管状腺瘤并增生性息肉建议定期复查	直肠良性肿瘤##管状腺瘤##直肠息肉	3
强直性脊柱炎并胸腰椎后凸畸形	强直性脊柱炎##胸椎后凸##腰椎后凸	3
直肠腺癌 第一次化疗	直肠恶性肿瘤##化学治疗##腺癌	3
前列腺癌骨髓侵犯	前列腺恶性肿瘤##骨髓继发恶性肿瘤##癌	3
宫颈中分化鳞癌IIB期化疗后	子宫颈恶性肿瘤##鳞状细胞癌##化学治疗	3
热液烫伤双股会阴部TBSA5%Ⅱ度	沸水烫伤##会阴烫伤##下肢烫伤	3
右乳浸润性癌内分泌治疗	乳腺恶性肿瘤##浸润性导管和小叶性癌##恶性肿瘤内分泌治疗	3
右肺小结节,乳腺癌	肺占位性病变##乳腺恶性肿瘤##癌	3
左侧咬肌区肿块（血管瘤？)	面部肿物##血管瘤##血管瘤	3
右乳增生病伴纤维腺瘤	乳腺良性肿瘤##纤维腺瘤##乳腺增生	3
高血压，脑梗塞缺血，	高血压##脑梗死##脑血管供血不足	3
冠心病不稳定性心绞痛陈旧心梗	冠状动脉粥样硬化性心脏病##不稳定性心绞痛##陈旧性心肌梗死	3
咳嗽待查上气道综合症？胃食管反流？	咳嗽##胃食管反流##上气道咳嗽综合征	3
右肺上叶浸润性腺癌维持性化学治疗	右肺上叶恶性肿瘤##恶性肿瘤维持性化学治疗##癌	3
血CA125CA199铁蛋白升高原因	CA199升高##CA125升高##血清铁蛋白异常	3
右乳非特殊类型浸润性癌 T2N1M0 IIB期	乳腺恶性肿瘤##癌##淋巴结继发恶性肿瘤	3
胰腺尾部CA化疗后	胰尾恶性肿瘤##癌##化学治疗	3
腹膜癌术后检查	腹膜恶性肿瘤##癌##恶性肿瘤手术后的随诊检查	3
耳廓肿物（纤维瘤）	耳廓肿物##耳廓良性肿瘤##纤维瘤	3
回肠炎性息肉致肠套叠	炎性息肉##小肠息肉##肠套叠	3
心律失常心房纤颤频发室性早搏	心律失常##心房颤动[心房纤颤]##频发性室性期前收缩	3
左甲状腺肿物性质待查：左甲状腺囊腺瘤？	甲状腺良性肿瘤##囊腺瘤##甲状腺肿物	3
沸水烫伤未愈肉芽创面21％躯干双下肢左?	沸水烫伤##躯干部烫伤##下肢烫伤	3
结肠肝曲管状腺瘤直肠管状腺瘤	结肠肝曲良性肿瘤##直肠良性肿瘤##管状腺瘤	3
肺Ca合并感染	肺恶性肿瘤##肺部感染##癌	3
结肠肝曲中分化腺癌（pT4aN0M0 IIB期）术后	结肠术后##结肠恶性肿瘤##腺癌	3
L1L2椎体骨质破坏伴L1椎体压缩性改变	骨质破坏##腰椎压缩性骨折##腰椎骨折L1	3
左胫腓骨远端粉碎性骨折，脑伤，颅底骨折等	胫骨远端骨折伴腓骨骨折##颅底骨折##创伤性脑损伤	3
直肠癌术后回肠造口还纳术	直肠术后##直肠恶性肿瘤##癌	3
全身多发转移癌I-125粒子植入术后	多部位继发恶性肿瘤##转移性癌##恶性肿瘤放射性粒子置入治疗	3
肝内及腹腔转移瘤	肝继发恶性肿瘤##腹腔继发恶性肿瘤##转移性肿瘤	3
左足第四趾肿物，恶黑？	足肿物##恶性黑色素瘤##恶性黑色素瘤	3
冠心病--心绞痛心功能2级	冠状动脉粥样硬化性心脏病##心绞痛##心功能Ⅱ级(NYHA分级)	3
食管鳞癌维持性化学治疗	食管恶性肿瘤##鳞状细胞癌##恶性肿瘤维持性化学治疗	3
右乳癌术前新辅助化疗	乳腺恶性肿瘤##化学治疗##癌	3
肠癌; 喉癌	肠道恶性肿瘤##喉恶性肿瘤##癌	3
外伤;膝关节损伤关节病;失眠	膝关节损伤##关节病##失眠	3
咽炎扁桃体炎支气管炎	扁桃体炎##咽炎##支气管炎	3
停经253周B超提示胎儿蝴蝶椎体	妊娠状态##先天性脊柱畸形##胎儿畸形	3
乘坐客车时翻车导致头胸腹部被撞击致伤	头部损伤##胸部损伤##腹部损伤	3
右肺MT伴肺转移？	右肺恶性肿瘤##肺继发恶性肿瘤##转移性肿瘤	3
前列腺癌(术后)	前列腺恶性肿瘤##癌##前列腺术后	3
多发腔隙性梗塞双基底节双额深右顶	腔隙性脑梗死##基底节脑梗死##多发性脑梗死	3
35、45牙本质过敏,17、47创伤性根周膜炎,14牙体楔状缺损	牙本质过敏症##牙齿楔状缺损##牙及相关组织损伤	3
右肺小细胞癌化疗后伽玛刀治疗后	右肺恶性肿瘤##小细胞癌##化学治疗	3
十二指肠壶腹癌IV期化疗	法特壶腹恶性肿瘤##癌##化学治疗	3
肺癌晚期，血尿待查	肺恶性肿瘤##癌##血尿	3
高尿酸肝脏功能轻度减退高血糖	高尿酸血症##肝功能异常##血糖升高	3
右肺中叶鳞癌维持性化学治疗	右肺中叶恶性肿瘤##鳞状细胞癌##恶性肿瘤维持性化学治疗	3
直肠高-中分化腺癌术后	直肠术后##直肠恶性肿瘤##腺癌	3
卵巢癌IV期第二次化疗后	卵巢恶性肿瘤##化学治疗##癌	3
胃周及腹主动脉周围淋巴结转移腹膜转移	胃淋巴结继发恶性肿瘤##淋巴结继发恶性肿瘤##腹膜继发恶性肿瘤	3
喉癌放疗后	喉恶性肿瘤##癌##恶性肿瘤放疗	3
膀胱癌术后(高级别尿路上皮癌)	膀胱术后##膀胱恶性肿瘤##尿路上皮癌	3
宫颈中分化鳞癌免疫治疗	子宫颈恶性肿瘤##鳞状细胞癌##恶性肿瘤免疫治疗	3
肺癌，镜下血尿	肺恶性肿瘤##血尿##癌	3
停经236周B超提示胎儿心脏双主动脉弓	妊娠状态##先天性双主动脉弓##胎儿先天性心脏病	3
高血压病,高血压病，抑郁症	高血压##高血压##抑郁症	3
右乳腺癌维持性化学治疗	乳腺恶性肿瘤##恶性肿瘤维持性化学治疗##癌	3
多发腔隙性梗死脑干双侧基底节及放射冠区	腔隙性脑梗死##基底节脑梗死##多发性脑梗死	3
低钾低钠待查过敏性性休克致	低钾血症##低钠血症##过敏性休克	3
上颌骨腺样囊性癌术后，多发腰椎转移	上颌骨恶性肿瘤##腺样囊性癌##转移性腺样囊性癌	3
右侧乳腺癌化疗	乳腺恶性肿瘤##化学治疗##癌	3
双侧第五跖骨破坏原因TB双踝韧带炎	骨质破坏##结核感染##韧带炎	3
糖尿病合并症高血压病上感重度骨关节病	糖尿病性高血压##上呼吸道感染##重度骨关节病	3
高镁低钾钙血症	高镁血症##低钾血症##低钙血症	3
颅内多发大动脉重度狭窄双侧椎动脉基底动脉	动脉狭窄##椎动脉狭窄##基底动脉狭窄	3
3颈胸腰椎体退行性改	颈椎退行性病变##胸椎退行性病变##腰椎退行性病变	3
卵巢浆液性腺癌IIIC期术后第四次化疗后	卵巢恶性肿瘤##浆液性腺癌##恶性肿瘤术后化疗	3
高血压糖尿病上感	高血压##糖尿病##上呼吸道感染	3
宫颈癌ⅡB放疗	子宫颈恶性肿瘤##放射治疗##癌	3
左结节性甲状腺肿 右甲状腺癌	结节性甲状腺肿##甲状腺恶性肿瘤##癌	3
前列腺癌复发	前列腺恶性肿瘤##癌##恶性肿瘤复发	3
子宫颈中高分化鳞癌维持性化学治疗	子宫颈恶性肿瘤##鳞状细胞癌##恶性肿瘤维持性化学治疗	3
支气管扩张;慢性阻塞性肺疾病;过敏性鼻炎(变应性鼻炎)	支气管扩张症##慢性阻塞性肺疾病##过敏性鼻炎[变应性鼻炎]	3
A7垂直阻生D2舌侧错位D3扭转	阻生牙##牙齿扭转##牙齿错位	3
腹痛(未特指);肠癌术后	腹痛##胃肠道恶性肿瘤##癌	3
直肠癌新辅助放化疗后	直肠恶性肿瘤##恶性肿瘤放疗##化学治疗##癌	4
肺癌(骨转移)	肺恶性肿瘤##癌##骨继发恶性肿瘤##转移性癌	4
颈部淋巴瘤 化疗	颈部恶性肿瘤##淋巴瘤##淋巴瘤##化学治疗	4
乳腺癌 骨转移癌可能	乳腺恶性肿瘤##癌##骨继发恶性肿瘤##转移性癌	4
脑动脉硬化;乏力;耳鸣;脑血管供血不足	乏力##耳鸣##脑血管供血不足##脑血管硬化	4
血管紧张性头痛,海绵状血管瘤，睡眠障碍,高血压病	血管性头痛##海绵状血管瘤##睡眠障碍##高血压	4
前列腺癌,双腹股沟淋巴结转移	前列腺恶性肿瘤##癌##腹股沟淋巴结继发恶性肿瘤##转移性癌	4
先天性心脏病：ASD,VSD,PDA	先天性心脏病##房间隔缺损##室间隔缺损##动脉导管未闭	4
直肠中分化腺癌根治术后 IIIc期 pT4aN2aM0	直肠术后##直肠恶性肿瘤##腺癌##淋巴结继发恶性肿瘤	4
胸椎腰椎双侧髋关节退变脊柱轻度侧弯	胸椎退行性病变##腰椎退行性病变##双侧髋关节骨性关节病##脊柱侧弯	4
胃占位性病变(胃溃疡？肝占位：原发性？转移瘤？)	胃占位性病变##胃溃疡##肝占位性病变##转移性肿瘤	4
左面颈部及牙龈肿物，CA?,疼痛	面部肿物##颈部肿物##癌##疼痛	4
胸腰椎多发陈旧骨折	胸椎多发性骨折##陈旧性胸椎骨折##腰椎多发性骨折##陈旧性腰椎骨折	4
宫颈鳞癌IIb期术后化疗后盆腔复发。	子宫颈恶性肿瘤##鳞状细胞癌##恶性肿瘤术后化疗##恶性肿瘤复发	4
MODS肝肾心功能障碍	多脏器功能障碍综合征[MODS]##肾功能异常##肝功能异常##心功能不全	4
乳腺增生并导管扩张及纤维腺瘤样增生	乳腺增生##乳腺导管扩张症##纤维腺瘤##乳腺良性肿瘤	4
右肾盂输尿管扩张积水	肾盂扩张##输尿管扩张##肾积水##输尿管积水	4
结肠癌术后每日更换造口袋1-2个	结肠术后##结肠恶性肿瘤##结肠造口状态##癌	4
甲状腺左叶乳状ca术后局部复发	甲状腺恶性肿瘤##甲状腺乳头状癌##甲状腺术后##恶性肿瘤复发	4
结肠癌晚期 肛周疼痛待查	结肠术后##结肠恶性肿瘤##癌##疼痛	4
脑梗死;冠状动脉粥样硬化性心脏病;心绞痛;脑动脉硬化	脑梗死##冠状动脉粥样硬化性心脏病##心绞痛##脑血管硬化	4
右肺上叶小细胞癌伽玛刀治疗后化疗后	右肺上叶恶性肿瘤##小细胞癌##化学治疗##恶性肿瘤放疗	4
喷门癌肝转移	贲门恶性肿瘤##癌##肝继发恶性肿瘤##转移性癌	4
高血压冠心病关节炎牙痛	高血压##冠状动脉粥样硬化性心脏病##关节炎##牙痛	4
右肺鳞癌放化疗后	右肺恶性肿瘤##鳞状细胞癌##恶性肿瘤放疗##化学治疗	4
降结肠管状腺瘤乙状结肠绒毛状-管状腺瘤	降结肠良性肿瘤##乙状结肠良性肿瘤##管状腺瘤##管状绒毛状腺瘤	4
糖尿病皮肤瘙痒症脑血管供血不足高血压	糖尿病##瘙痒(症)##脑血管供血不足##高血压	4
贲门癌术后 进食不畅	贲门术后##贲门恶性肿瘤##进食障碍##癌	4
子宫颈鳞癌IIB期放疗后	子宫颈恶性肿瘤##鳞状细胞癌##恶性肿瘤放疗##化学治疗	4
肝癌冷冻术后/乙肝肝硬化	肝术后##肝恶性肿瘤##乙型肝炎肝硬化##癌	4
子宫颈鳞癌IIB期放化疗后	子宫颈恶性肿瘤##鳞状细胞癌##恶性肿瘤放疗##化学治疗	4
左肺部块影待查：肺恶性肿瘤？肺炎？肺结核？	肺部阴影##左肺恶性肿瘤##肺炎##肺结核	4
前列腺癌？骨转移？	前列腺恶性肿瘤##癌##骨继发恶性肿瘤##转移性癌	4
肝癌,肝硬化,肝昏迷	肝恶性肿瘤##肝硬化##肝性脑病##癌	4
随诊检查,恶性肿瘤手术后(食管癌，喉癌)	食管恶性肿瘤##喉恶性肿瘤##恶性肿瘤手术后的随诊检查##癌	4
右乳腺浸润性癌术后化疗后靶向治疗（pT2N0M0	乳腺恶性肿瘤##恶性肿瘤术后化疗##恶性肿瘤术后靶向治疗##癌	4
右乳癌术后 右上纵隔肿物,准备穿刺,气管镜检查,预防出血	乳腺术后##乳腺恶性肿瘤##纵隔肿物##癌	4
肾功能不全;支气管炎;免疫缺陷病;冠心病	肾功能不全##支气管炎##免疫缺陷##冠状动脉粥样硬化性心脏病	4
高血压/胸闷/颈动脉狭窄/晕厥	高血压##胸闷##颈动脉狭窄##晕厥	4
高血压病,糖尿病,冠心病，白内障	高血压##糖尿病##冠状动脉粥样硬化性心脏病##白内障	4
宫颈中分化鳞癌IIb期术后放化疗后	子宫颈恶性肿瘤##鳞状细胞癌##恶性肿瘤术后化疗##恶性肿瘤术后放疗	4
右足跟黑色素瘤 双肺转移	足恶性肿瘤##恶性黑色素瘤##肺继发恶性肿瘤##转移性恶性黑色素瘤	4
硒肺咳嗽。喘。胸闷	矽肺[硅沉着病]##咳嗽##喘息##胸闷	4
右肾盂及输尿管扩张积水	肾盂扩张##输尿管扩张##肾积水##输尿管积水	4
双肺内、第3胸椎、右髂骨转移不除外	肺继发恶性肿瘤##髂骨继发恶性肿瘤##胸椎继发恶性肿瘤##转移性肿瘤	4
肝癌，化疗后血细胞低下	肝恶性肿瘤##化疗药物反应##全血细胞减少##癌	4
肝癌伴肝内转移	肝恶性肿瘤##癌##肝继发恶性肿瘤##转移性癌	4
多发性骨髓瘤 (IGG K轻链型 DS分期IIA期 ISS分期II期 NCR)	多发性骨髓瘤(IgGк型)##多发性骨髓瘤(轻链к型)##多发性骨髓瘤(DS分期II期)##多发性骨髓瘤(ISS分期II期)	4
颈段食管癌cT3N0M0 放化疗	食管颈部恶性肿瘤##恶性肿瘤放疗##化学治疗##癌	4
宫颈炎性疾病，子宫肌瘤术后	宫颈炎性疾病##子宫平滑肌瘤##子宫平滑肌瘤##子宫术后	4
右颈面部鳞状细胞癌放化疗后	头、面和颈部恶性肿瘤##鳞状细胞癌##恶性肿瘤放疗##化学治疗	4
左肺上叶腺癌cT3N3M0 IIIB期（第八版） 化疗	左肺上叶恶性肿瘤##腺癌##化学治疗##淋巴结继发恶性肿瘤	4
直肠癌术后复查;回肠造口术后	直肠术后##直肠恶性肿瘤##癌##回肠造口状态	4
宫颈腺癌放化疗后	子宫颈恶性肿瘤##腺癌##恶性肿瘤放疗##化学治疗	4
宫颈中分化鳞癌IIB期放化疗后	子宫颈恶性肿瘤##鳞状细胞癌##化学治疗##恶性肿瘤放疗	4
乳腺癌综合治疗后，III度骨髓抑制	乳腺术后##乳腺恶性肿瘤##癌##骨髓抑制	4
胃体神经内分泌癌,肝转移	胃体恶性肿瘤##神经内分泌癌##肝继发恶性肿瘤##转移性神经内分泌癌	4
门静脉高压症：食管胃底静脉曲张、脾大	门静脉高压##食管静脉曲张##胃底静脉曲张##脾大	4
口底鳞癌放化疗后	口底恶性肿瘤##鳞状细胞癌##恶性肿瘤放疗##化学治疗	4
冠心病心房纤颤高血压头痛	冠状动脉粥样硬化性心脏病##心房颤动[心房纤颤]##高血压##头痛	4
子宫颈鳞状细胞癌ⅢB期放化疗后	子宫颈恶性肿瘤##鳞状细胞癌##恶性肿瘤放疗##化学治疗	4
左乳腺癌术后,双肺小结节	乳腺术后##乳腺恶性肿瘤##肺占位性病变##癌	4
乳癌痹症 冠心病(心律失常)	乳腺恶性肿瘤##癌##冠状动脉粥样硬化性心脏病##心律失常	4
结肠癌，上感，肠炎	结肠恶性肿瘤##癌##上呼吸道感染##肠炎	4
双股骨及双胫腓骨多发骨软骨瘤	股骨良性肿瘤##腓骨良性肿瘤##胫骨良性肿瘤##骨软骨瘤	4
宫颈鳞癌Ⅲb期化疗后放疗中	子宫颈恶性肿瘤##鳞状细胞癌##化学治疗##恶性肿瘤放疗	4
回肠腺癌术后第4次化疗	回肠术后##回肠恶性肿瘤##腺癌##恶性肿瘤术后化疗	4
多发颅神经炎面神经三叉神经前庭神经	多发性脑神经炎##面神经炎##三叉神经炎##前庭神经炎	4
便秘;结膜炎;慢性喘息性支气管炎;胃炎;冠心病心律失常型	便秘##结膜炎##胃炎##冠心病心律失常型	4
鼻咽癌放化疗术后6年复查	鼻咽恶性肿瘤##癌##恶性肿瘤放疗##化学治疗	4
肠癌 高血压 糖尿病（去外地带药）	肠道恶性肿瘤##高血压##糖尿病##癌	4
盲肠肝曲横结肠远段管状腺瘤	管状腺瘤##横结肠良性肿瘤##盲肠良性肿瘤##结肠肝曲良性肿瘤	4
双侧基底节区多发陈旧腔梗	基底节脑梗死##腔隙性脑梗死##多发性脑梗死##陈旧性脑梗死	4
右腮腺鳞癌放化疗后	腮腺恶性肿瘤##鳞状细胞癌##恶性肿瘤放疗##化学治疗	4
右乳浸润性导管癌伴肝脏转移	乳腺恶性肿瘤##肝继发恶性肿瘤##浸润性导管癌##转移性导管癌	4
冠状动脉供血不足;高脂血症;焦虑状态;支架植入术后状态	冠状动脉供血不足##高脂血症##焦虑状态##冠状动脉支架植入术后状态	4
咯血待查：支气管扩张伴感染?肺恶性肿瘤？	咯血##支气管扩张症##感染##肺恶性肿瘤	4
子宫内膜癌术后;失眠症	子宫术后##子宫内膜恶性肿瘤##癌##失眠	4
高血压冠心病房颤肿瘤	高血压##冠状动脉粥样硬化性心脏病##心房颤动[心房纤颤]##性质未特指的肿瘤	4
电解质代谢紊乱低钾低钠低氯血症	电解质紊乱##低钠血症##低钾血症##低氯血症	4
脑梗塞关节炎抑郁症支气管炎	脑梗死##关节炎##支气管炎##抑郁症	4
前列腺癌；糖尿病；高血压	前列腺恶性肿瘤##癌##糖尿病##高血压	4
左肺不典型类癌,骨转移？	左肺恶性肿瘤##骨继发恶性肿瘤##类癌瘤##转移性类癌	4
手足体股癣	手癣##足癣##体癣[钱癣]##股癣	4
左骨盆骨肉瘤复发术后(ENNEKING分期 III期)	骨盆恶性肿瘤##骨肉瘤##盆腔术后##恶性肿瘤复发	4
原发性肝癌;慢性乙型病毒性肝炎,肝硬化;	肝恶性肿瘤##慢性乙型病毒性肝炎##肝硬化##癌	4
发热;上呼吸道感染?;泌尿道感染?	发热##上呼吸道感染##感染##部位未特指的泌尿道感染	4
子宫内膜癌 慢支 化疗中	子宫内膜恶性肿瘤##慢性支气管炎##化学治疗##癌	4
工伤骨折骨关节病关节痛	工作中的意外损伤##骨折##骨关节病##关节痛	4
腰腿痛/心律失常/感冒	腰痛##下肢疼痛##心律失常##感冒	4
升结肠癌,腹腔转移术后	升结肠恶性肿瘤##癌##腹腔继发恶性肿瘤##转移性癌	4
多处皮肤撕裂伤（污染严重）头皮血肿多处软组织损伤脑伤？内脏损伤？	多处撕裂伤##头皮血肿##多处损伤##创伤性脑损伤	4
四肢抖动待查低钙脑损伤新生儿良性惊	不自主运动##低钙血症##良性新生儿惊厥##新生儿脑损伤	4
宫颈鳞癌放化疗后反复	子宫颈恶性肿瘤##鳞状细胞癌##化学治疗##恶性肿瘤放疗	4
乏力，纳差，恶心，胸闷，心梗可能	乏力##食欲不振##恶心##胸闷	4
胃癌全切术后,恶性腹腔积液	胃术后##胃恶性肿瘤##癌##恶性腹腔积液	4
胰腺癌并T2椎体、左侧髂骨转移	胰腺恶性肿瘤##癌##髂骨继发恶性肿瘤##转移性癌	4
宫颈中高分化鳞癌IIIb期放化疗后	子宫颈恶性肿瘤##鳞状细胞癌##化学治疗##恶性肿瘤放疗	4
多脏器功能不全肝肾凝血功能障碍	多脏器功能障碍综合征[MODS]##肝功能异常##凝血功能障碍##肾功能异常	4
颈椎病,颈项痛,腰腿痛	颈椎病##颈痛##腰痛##下肢疼痛	4
头晕,高血压,糖尿病；脑出血恢复期	头晕##高血压##糖尿病##脑出血恢复期	4
胃癌 疼痛 不能进食	胃恶性肿瘤##疼痛##进食障碍##癌	4
子宫颈鳞癌放化疗后IIIB期	子宫颈恶性肿瘤##鳞状细胞癌##恶性肿瘤放疗##化学治疗	4
糖尿病,2型糖尿病,2型糖尿病性视网膜病变,冠状动脉性心脏病	糖尿病##2型糖尿病##2型糖尿病性视网膜病变##冠状动脉性心脏病	4
阴道鳞癌Ⅰ期放化疗后	阴道恶性肿瘤##鳞状细胞癌##恶性肿瘤放疗##化学治疗	4
冠心病高血压脑梗塞结膜炎	冠状动脉粥样硬化性心脏病##高血压##脑梗死##结膜炎	4
头外伤后神经反应软组织挫伤感染水肿疼痛	头部损伤##感染##头痛##水肿	4
胃窦癌伴肝转移术后	胃窦恶性肿瘤##癌##肝继发恶性肿瘤##转移性癌	4
直肠乙状结肠结合部中分化腺癌术后 IV期化疗	直肠恶性肿瘤##乙状结肠恶性肿瘤##恶性肿瘤术后化疗##腺癌	4
结膜炎;结膜下出血;白内障术后	结膜炎##结膜下出血##白内障##眼术后	4
电解质紊乱-低钠钾氯血症	电解质紊乱##低钠血症##低钾血症##低氯血症	4
肾积水伴肾和输尿管结石(术后)	肾积水##肾输尿管结石##肾术后##输尿管术后	4
右肺鳞癌IV期，肝癌,失眠	右肺恶性肿瘤##鳞状细胞癌##肝恶性肿瘤##失眠	4
颈部淋巴结肿大原因待查,甲状腺癌术后	颈淋巴结肿大##甲状腺术后##甲状腺恶性肿瘤##癌	4
左侧肩背外伤痛	肩部损伤##躯干未特指的损伤,水平未特指##肩痛##背痛	4
特指手术后状态(右髋骨、手掌骨折术后)	其他特指的手术后状态##骨盆骨折##掌骨骨折##骨折术后	4
脑干小脑梗死多发性腔隙性脑梗死	小脑梗死##脑干梗死##多发性脑梗死##腔隙性脑梗死	4
肺癌抗过敏,肝转移？	肺恶性肿瘤##癌##肝继发恶性肿瘤##转移性癌	4
鼻衄贫血待查：失血性？血小板减少性紫癜	鼻出血[鼻衄]##贫血##血小板减少性紫癜##失血性贫血	4
特指手术后状态(右肝癌术后)	肝恶性肿瘤##癌##肝术后##其他特指的手术后状态	4
盲肠升结肠横结肠管状腺瘤	盲肠良性肿瘤##升结肠良性肿瘤##横结肠良性肿瘤##管状腺瘤	4
冠心病;骨质疏松;高血压;脑动脉硬化	冠状动脉粥样硬化性心脏病##骨质疏松##高血压##脑血管硬化	4
周围神经病变右侧腋神经正中神经尺神经损害	多发性神经病[多发性神经炎/周围神经炎]##尺神经损害##正中神经损害##腋神经损伤	4
高血压，冠心病，肾衰，抑郁症	高血压##冠状动脉粥样硬化性心脏病##肾衰竭##抑郁症	4
; 直肠癌术后; 内痔	直肠术后##直肠恶性肿瘤##内痔##癌	4
肾小球肾炎丙肝携带高血压肝损害	肾小球肾炎##丙型肝炎病毒携带者##高血压##肝损害	4
重度骨质疏松症冠心病高血压结缔组织病	重度骨质疏松##冠状动脉粥样硬化性心脏病##高血压##结缔组织病	4
乳腺癌,骨质疏松,疼痛	乳腺恶性肿瘤##癌##骨质疏松##疼痛	4
骨关节病;坐骨神经痛肌肉关节酸痛行动不便	骨关节病##坐骨神经痛##肌痛##关节痛	4
乳腺癌肝转移	乳腺恶性肿瘤##癌##肝继发恶性肿瘤##转移性癌	4
肾癌术后晚期 严重肝损伤	肾恶性肿瘤##肾术后##肝损害##癌	4
宫颈低中分化鳞癌IIIb期放化疗后	子宫颈恶性肿瘤##鳞状细胞癌##化学治疗##恶性肿瘤放疗	4
颈椎腰椎病醣尿病脑缺血	颈椎病##糖尿病##脑血管供血不足##腰椎病	4
宫颈鳞状细胞癌IIIB期放化疗后	子宫颈恶性肿瘤##鳞状细胞癌##化学治疗##恶性肿瘤放疗	4
左舌癌术后复发	舌术后##舌恶性肿瘤##癌##恶性肿瘤复发	4
糖尿病消化不良高尿酸高血脂	糖尿病##消化不良##高尿酸血症##高脂血症	4
左肺非小细胞肺癌Ⅳb期 cT4 N2 M1c 化疗	左肺恶性肿瘤##非小细胞癌##化学治疗##淋巴结继发恶性肿瘤	4
冠心病高血压糖尿病骨关节病	冠状动脉粥样硬化性心脏病##高血压##糖尿病##骨关节病	4
左肺周围型小细胞肺癌广泛期放化疗 ,胃镜检查 置管,无法进食	左肺恶性肿瘤##小细胞癌##放射治疗##化学治疗	4
糖尿病高血压并脑损害心脏损害	糖尿病##高血压##未特指的脑病##心脏损伤	4
缺铁缺锌铅较高腹部淋巴肿大	铁缺乏##锌缺乏##铅中毒##淋巴结肿大	4
高血压;冠心病心律失常型;支架术后;前列腺增生	高血压##冠心病心律失常型##冠状动脉支架植入术后状态##前列腺增生	4
冠心病急性广泛前壁ST段抬高型心肌梗死单支病变累及LADLADPCI术后心功能I级（Killip分级）	冠状动脉粥样硬化性心脏病##急性ST段抬高型心肌梗死##KillipI级##PCI术后	4
纵隔畸胎瘤术后伴多发骨转移	纵隔恶性肿瘤##恶性畸胎瘤##骨继发恶性肿瘤##转移性畸胎瘤	4
食管鳞状细胞化放疗	食管恶性肿瘤##鳞状细胞癌##恶性肿瘤放疗##化学治疗	4
肝功能异常癌症放化疗	肝功能异常##化学治疗##恶性肿瘤放疗##癌症	4
食管鳞ca 胃食管结合部腺ca	食管恶性肿瘤##鳞状细胞癌##食管胃连接部恶性肿瘤##腺癌	4
左上肺周围型低分化腺癌纵隔淋巴结转移 上呼吸道感染	左肺上叶恶性肿瘤##腺癌##纵隔淋巴结继发恶性肿瘤##转移性腺癌##上呼吸道感染	5
横结肠癌 肠道出血 缺铁性贫血,叶酸缺乏,乙型肝炎	横结肠恶性肿瘤##肠出血##缺铁性贫血##叶酸缺乏##癌	5
右肺腺癌 cT4N3M1c IV期免疫+靶向治疗	右肺恶性肿瘤##腺癌##恶性肿瘤免疫治疗##恶性肿瘤靶向治疗##淋巴结继发恶性肿瘤	5
原发性肝癌,慢性乙型病毒性肝炎,肝炎后肝硬变,门脉癌栓	肝恶性肿瘤##癌##慢性乙型病毒性肝炎##肝炎肝硬化##门静脉瘤栓	5
直肠癌术后4年，确诊为复发放疗中	直肠术后##直肠恶性肿瘤##放射治疗##恶性肿瘤复发##癌	5
右乳浸润性导管癌改良根治术后Ⅲa期（ypT1N2M0）化疗	乳腺恶性肿瘤##乳腺术后##浸润性导管癌##恶性肿瘤术后化疗##淋巴结继发恶性肿瘤	5
右股骨骨折右胫骨骨折右下肢皮肤软组织挫裂伤，右肱骨髁上骨折	股骨骨折##胫骨骨折##下肢未特指的损伤,水平未特指##肱骨骨折##肱骨髁上骨折	5
胆结石高血压病胃脘痛咽痛结膜炎	胆石症##高血压##胃痛##咽痛##结膜炎	5
胃癌术后骨转移术后	胃术后##胃恶性肿瘤##癌##骨继发恶性肿瘤##转移性癌	5
食管贲门低分化鳞癌并下颈部锁骨上淋巴结等转移	食管恶性肿瘤##贲门恶性肿瘤##颈部淋巴结继发恶性肿瘤##锁骨上淋巴结继发恶性肿瘤##鳞状细胞癌	5
乙状结肠癌术后复查 慢支 化疗	结肠术后##乙状结肠恶性肿瘤##慢性支气管炎##化学治疗##癌	5
直肠癌晚期,肝转移，化疗	直肠恶性肿瘤##肝继发恶性肿瘤##化学治疗##癌##转移性癌	5
左肾透明细胞癌术后多发骨转移	肾术后##肾恶性肿瘤##透明细胞癌##骨继发恶性肿瘤##转移性透明细胞癌	5
左眼睑结膜恶性黑色素瘤术后,反复复发术后,	结膜恶性肿瘤##眼睑恶性黑色素瘤##恶性黑色素瘤##眼术后##恶性肿瘤复发	5
骨髓增生异常综合征，直肠癌术后	骨髓增生异常综合征##骨髓增生异常综合征##直肠术后##直肠恶性肿瘤##癌	5
黑色素瘤, 颈椎皮下转移,多发骨转移,癌痛	黑色素瘤##骨继发恶性肿瘤##颈部继发恶性肿瘤##癌性疼痛##转移性肿瘤	5
直肠癌术后 骨髓转移？	直肠术后##直肠恶性肿瘤##癌##骨髓继发恶性肿瘤##转移性癌	5
右侧乳腺粘液癌术后,放射治疗,上感	乳腺术后##乳腺恶性肿瘤##粘液癌##恶性肿瘤放疗##上呼吸道感染	5
腰椎双膝骨关节病行动不便肌肉关节痛颈椎病	膝骨关节病##肌痛##关节痛##颈椎病##腰椎病	5
冠心病高血压病腰腿痛脑血栓	冠状动脉粥样硬化性心脏病##高血压##脑血栓形成##腰痛##下肢疼痛	5
1.冠心病，陈旧前壁心梗，PTCA+支架术后；2.高血压病2级（极高危）；3.高脂血症。	冠状动脉粥样硬化性心脏病##陈旧性前壁心肌梗死##冠状血管成形术后状态##血管支架植入术后状态##高脂血症	5
上呼吸道感染慢性咽炎感冒,口腔黏膜溃疡,胃镜检查,病毒性感冒	上呼吸道感染##慢性咽炎##感冒##口腔黏膜溃疡##病毒性感冒	5
鼻咽顶壁、顶后壁及右侧壁未分化型非角化性癌肺转移	鼻咽顶恶性肿瘤##鼻咽侧壁恶性肿瘤##未分化的癌##肺继发恶性肿瘤##转移性癌	5
左侧腹股沟、阴茎及阴囊皮肤低分化大汗腺癌	腹股沟恶性肿瘤##阴茎恶性肿瘤##阴囊恶性肿瘤##汗腺恶性肿瘤##癌	5
乙状结肠粘液腺癌伴梗阻、肝转移 pT4N0M1 IVa期	乙状结肠恶性肿瘤##粘液腺癌##结肠梗阻##肝继发恶性肿瘤##转移性粘液腺癌	5
直肠癌放化疗后 T3N1M0 IIIB期	直肠恶性肿瘤##癌##恶性肿瘤放疗##化学治疗##淋巴结继发恶性肿瘤	5
直肠癌,化疗,贫血,肝损伤	直肠恶性肿瘤##化学治疗##贫血##肝损伤##癌	5
直肠中分化粘液腺癌根治术后(pT4bN1M0)IIIC期化疗	直肠术后##直肠恶性肿瘤##粘液腺癌##恶性肿瘤术后化疗##淋巴结继发恶性肿瘤	5
纵膈双侧锁骨下腹腔及腹膜后淋巴结多发转	纵隔淋巴结继发恶性肿瘤##锁骨下淋巴结继发恶性肿瘤##腹腔淋巴结继发恶性肿瘤##腹膜后淋巴结继发恶性肿瘤##转移性肿瘤	5
左肺上叶周围型腺癌cT1aN3M1 IV期左侧胸膜及叶间胸膜转移左侧恶性	左肺上叶恶性肿瘤##腺癌##胸膜继发恶性肿瘤##转移性腺癌##淋巴结继发恶性肿瘤	5
咽喉炎，感冒;右侧肺炎，糖尿病	咽炎##喉炎##感冒##肺炎##糖尿病	5
卵巢癌术后,盆腔复发?	卵巢术后##卵巢恶性肿瘤##盆腔继发恶性肿瘤##癌##恶性肿瘤复发	5
肝脏转移 化疗,白细胞低下,尿路感染,肝功能	肝继发恶性肿瘤##化学治疗##白细胞减少##泌尿系感染##转移性肿瘤	5
肝癌术后复发介入治疗后双肺转移	肝术后##肝恶性肿瘤##癌##肺继发恶性肿瘤##转移性癌	5
胰腺癌术后,胃排空障碍,胰腺肿瘤,胰腺分泌功能不足,腹膜后肿大淋巴结,转氨酶升高	胰腺术后##胰腺恶性肿瘤##癌##腹膜后淋巴结肿大##转氨酶升高	5
直肠癌术后。低蛋白血症、前列腺增生	直肠术后##直肠恶性肿瘤##癌##低蛋白血症##前列腺增生	5
卵巢癌术后复发第六次化疗后	卵巢术后##卵巢恶性肿瘤##恶性肿瘤复发##癌##化学治疗	5
右肺腺癌,纵隔淋巴结转移,左肾上腺转移	右肺恶性肿瘤##腺癌##纵隔淋巴结继发恶性肿瘤##肾上腺继发恶性肿瘤##转移性腺癌	5
结肠癌术后复查，出血便秘，肠镜检查，预防出血	结肠术后##结肠恶性肿瘤##出血##便秘##癌	5
骨关节病(颈肩腰腿痛)	骨关节病##腰痛##颈痛##肩痛##下肢疼痛	5
阴道炎,要求取环,月经不调,痛经,子宫腺肌症,盆腔炎	阴道炎##月经紊乱##痛经##子宫肌腺症##女性盆腔炎	5
慢性气管炎,高血压,冠心病,重度骨关节病,失眠,行动不便,	慢性气管炎##高血压##冠状动脉粥样硬化性心脏病##重度骨关节病##失眠	5
右肺癌术后 双肺多发转移 脑转移	肺术后##右肺恶性肿瘤##肺继发恶性肿瘤##脑继发恶性肿瘤##转移性癌	5
右肺小细胞肺癌 广泛期 纵隔淋巴结转移 双肺转移	右肺恶性肿瘤##小细胞癌##纵隔淋巴结继发恶性肿瘤##肺继发恶性肿瘤##转移性小细胞癌	5
原发性扩张型心肌病，全心扩大，心房纤颤、偶发室性早搏，心功能Ⅲ级	扩张性心肌病[充血性心肌病]##心脏扩大##心房颤动[心房纤颤]##室性期前收缩##心功能III级(NYHA分级)	5
直肠癌 盆腔淋巴结转移,术前放化疗	直肠恶性肿瘤##盆腔淋巴结继发恶性肿瘤##恶性肿瘤术前放疗##恶性肿瘤术前化疗##癌	5
肠癌肝转移？,肠镜检查,出血倾向	肠道恶性肿瘤##癌##肝继发恶性肿瘤##转移性癌##出血倾向	5
子宫平滑肌瘤，伴腺瘤样瘤性平滑肌瘤和腺肌症；增生期样子宫内膜；慢性宫颈炎。	子宫平滑肌瘤##子宫平滑肌瘤##子宫肌腺症##子宫内膜增生##慢性子宫颈炎	5
前列腺ca术后多发骨转移	前列腺恶性肿瘤##癌##前列腺术后##骨继发恶性肿瘤##转移性癌	5
乙状结肠癌肝转移姑息术后腹腔淋巴结转移综合治疗后	乙状结肠恶性肿瘤##肝继发恶性肿瘤##腹腔淋巴结继发恶性肿瘤##癌##转移性癌	5
肝癌术后; 低蛋白血症; 肝硬化	肝术后##肝恶性肿瘤##低蛋白血症##肝硬化##癌	5
胆囊癌并肝转移伴梗阻性黄疸	胆囊恶性肿瘤##癌##梗阻性黄疸##肝继发恶性肿瘤##转移性癌	5
哮喘，慢支，肺气肿;肺部感染，动脉硬化;	支气管哮喘##慢性支气管炎##肺气肿##肺部感染##动脉硬化	5
左乳癌可疑肺M，CT3N2Mx luminal B2	乳腺恶性肿瘤##癌##肺继发恶性肿瘤##转移性癌##淋巴结继发恶性肿瘤	5
乙状结肠癌，肝转移，膀胱转移	乙状结肠恶性肿瘤##癌##肝继发恶性肿瘤##转移性癌##膀胱继发恶性肿瘤	5
胸中下段食管癌伴纵隔、左颈多发淋巴结转移	食管胸中段恶性肿瘤##食管胸下段恶性肿瘤##癌##颈部淋巴结继发恶性肿瘤##纵隔淋巴结继发恶性肿瘤	5
直肠癌肝转移术后,肺转移.	直肠恶性肿瘤##肝继发恶性肿瘤##肺继发恶性肿瘤##癌##转移性癌	5
食管鳞癌 咳嗽,肺部感染,胃炎	食管恶性肿瘤##鳞状细胞癌##咳嗽##肺部感染##胃炎	5
结肠MTlater术后，前列腺MT术后，腹主动脉血管瘤术后	结肠术后##结肠恶性肿瘤##前列腺恶性肿瘤##前列腺术后##腹主动脉瘤	5
高血压Ⅲ;高脂血症;周围神经病;脑梗死;骨质疏松	高血压3级##高脂血症##多发性神经病[多发性神经炎/周围神经炎]##脑梗死##骨质疏松	5
结肠癌,呃逆,焦虑抑郁状态	结肠恶性肿瘤##呃逆##癌##焦虑状态##抑郁状态	5
乳腺癌术后骨转移严重骨质疏松	乳腺术后##乳腺恶性肿瘤##癌##骨继发恶性肿瘤##重度骨质疏松##转移性癌	6
乳腺癌改良根治术后，化疗，上感\发烧	乳腺术后##乳腺恶性肿瘤##恶性肿瘤术后化疗##上呼吸道感染##发热##癌	6
高血压病,糖尿病,冠心病，皮炎,心律失常,泌尿道感染	高血压##糖尿病##冠状动脉粥样硬化性心脏病##皮炎##心律失常##泌尿系感染	6
右肺腺癌，骨转移，化疗，骨破坏	右肺恶性肿瘤##腺癌##骨继发恶性肿瘤##化学治疗##骨质破坏##转移性腺癌	6
腰重度疼痛,椎体多发骨破坏,左肺上叶肺癌？,肝转移	腰痛##骨质破坏##左肺上叶恶性肿瘤##肝继发恶性肿瘤##癌##转移性癌	6
结肠中分化腺癌根治术后PT4N1M0 盆腔转移	结肠术后##结肠恶性肿瘤##腺癌##盆腔继发恶性肿瘤##转移性粘液腺癌##淋巴结继发恶性肿瘤	6
右肺腺癌并多发脑转移放疗后，多发骨转移	右肺恶性肿瘤##腺癌##脑继发恶性肿瘤##恶性肿瘤放疗##骨继发恶性肿瘤##转移性腺癌	6
心绞痛;支架植入术后状态;高脂血症;咳嗽;失眠;高血压	心绞痛##高脂血症##咳嗽##失眠##高血压##冠状动脉支架植入术后状态	6
左上肺鳞癌伴左肺门及左纵隔淋巴结、肝转移 Ⅳ期	左肺上叶恶性肿瘤##鳞状细胞癌##肺继发恶性肿瘤##纵隔淋巴结继发恶性肿瘤##肝继发恶性肿瘤##转移性鳞状细胞癌	6
结肠癌术后，肝转移，肾上腺转移	结肠术后##癌##结肠恶性肿瘤##肝继发恶性肿瘤##转移性癌##肾上腺继发恶性肿瘤	6
右乳癌IV期术后,肝转移,骨转移,赫赛汀耐药	乳腺术后##乳腺恶性肿瘤##癌##肝继发恶性肿瘤##骨继发恶性肿瘤##转移性癌	6
直肠癌 盆腔淋巴结转移 术前放化疗,恶心 呕吐	直肠恶性肿瘤##盆腔淋巴结继发恶性肿瘤##恶性肿瘤术前放疗##恶性肿瘤术前化疗##恶心和呕吐##癌	6
右肺癌伴肺内转移 肝内转移 骨转移	右肺恶性肿瘤##癌##肺继发恶性肿瘤##肝继发恶性肿瘤##骨继发恶性肿瘤##转移性癌	6
原发性肝癌术后复发伴肺、骨多发转移	肝术后##肝恶性肿瘤##恶性肿瘤复发##肺继发恶性肿瘤##骨继发恶性肿瘤##癌	6
食管癌 造影检查,纵隔腹腔淋巴结转移,胃镜检查、局麻、预防出血,疼痛,成人不能进食、鼻饲	食管恶性肿瘤##纵隔淋巴结继发恶性肿瘤##腹腔淋巴结继发恶性肿瘤##疼痛##进食障碍##癌	6
胃癌，胃镜检查, 术后化疗呕吐肝功能障碍,慢性肝炎	胃恶性肿瘤##恶性肿瘤术后化疗##呕吐##肝功能异常##慢性肝炎##癌	6
宫颈癌 肠镜检查 肠道准备 肠镜麻醉,焦虑抑郁状态伴失眠，神经痛	子宫颈恶性肿瘤##焦虑状态##抑郁状态##失眠##神经痛##癌	6
直肠癌术后ypT2N0M0,高血压,冠心病,双肾囊肿	直肠术后##直肠恶性肿瘤##高血压##冠状动脉粥样硬化性心脏病##癌##肾囊肿	6
软组织感染;动脉粥样硬化并高脂血症;冠状动脉粥样硬化性心脏病;周围神经病;慢性支气管炎;贫血	软组织感染##动脉粥样硬化##高脂血症##冠状动脉粥样硬化性心脏病##慢性支气管炎##贫血	6
胃癌,肝转移,骨转移,肝功异常	胃恶性肿瘤##癌##肝继发恶性肿瘤##骨继发恶性肿瘤##转移性癌##肝功能异常	6
右肺腺癌术后化疗放疗后，脑M，CT显示复发。	右肺恶性肿瘤##腺癌##脑继发恶性肿瘤##恶性肿瘤术后放疗##恶性肿瘤术后化疗##恶性肿瘤复发	6
心律失常胆汁反流性胃炎,乳腺增生,咳嗽待查（肺小结节）,腹部不适,胃镜检查，肠镜检查	心律失常##反流性胃炎##乳腺增生##咳嗽##肺占位性病变##胆汁反流	6
胰腺癌术后腹腔广泛转移 肺转移？	胰腺恶性肿瘤##癌##肺继发恶性肿瘤##腹腔继发恶性肿瘤##转移性癌##广泛转移性肿瘤	6
食管胸中段癌,化疗呕吐,反流性食管炎,白细胞低	食管胸中段恶性肿瘤##癌##化疗药物反应##呕吐##反流性食管炎##白细胞减少	6
前列腺癌根治性切除术后,前列腺癌生化复发 局部放疗	前列腺术后##前列腺恶性肿瘤##前列腺恶性肿瘤##恶性肿瘤复发##恶性肿瘤放疗##癌	6
头晕心悸待查：高血压;椎-基底动脉供血不全;冠心病心律失常型;心绞痛	头晕##心悸##高血压##椎-基底动脉供血不全##冠心病心律失常型##心绞痛	6
乙状结肠癌术后，，淋巴结转移，，呕吐，化疗肠镜检查	结肠术后##乙状结肠恶性肿瘤##癌##淋巴结继发恶性肿瘤##呕吐##化学治疗	6
右上肺癌伴全身多发转移（IV期 骨、脑）	右肺上叶恶性肿瘤##多部位继发恶性肿瘤##脑继发恶性肿瘤##骨继发恶性肿瘤##癌##转移性癌	6
脂肪肝，乳腺癌术后 化疗 严重骨质蔬松症	脂肪肝##乳腺术后##乳腺恶性肿瘤##癌##重度骨质疏松##恶性肿瘤术后化疗	6
左乳癌术后伴双肺、多发骨转移综	乳腺术后##癌##乳腺恶性肿瘤##肺继发恶性肿瘤##骨继发恶性肿瘤##转移性癌	6
疼痛 药物过敏性皮疹,左肺腺癌IV期,上呼吸道感染，咳嗽	疼痛##药物过敏性接触性皮炎##左肺恶性肿瘤##腺癌##上呼吸道感染##咳嗽	6
右上肺中央型腺鳞癌（pT2N2M0, IIIa期）术后伴右肺、右胸壁、肋骨多发转	肺术后##右肺上叶恶性肿瘤##鳞状细胞癌##肺继发恶性肿瘤##胸壁继发恶性肿瘤##肋骨继发恶性肿瘤##转移性癌	7
特指手术后状态(甲状腺癌术后、子宫肌瘤剜除术后、宫外孕术后)	其他特指的手术后状态##甲状腺恶性肿瘤##甲状腺术后##癌##子宫平滑肌瘤##子宫术后##异位妊娠	7
肺腺鳞癌,脑转移,非小细胞肺癌晚期,化疗止吐,抗过敏	肺恶性肿瘤##腺鳞癌##脑继发恶性肿瘤##非小细胞癌##肺恶性肿瘤##化学治疗##转移性腺鳞癌	7
脑梗死;高脂血症;痛风;周围神经病;睡眠障碍;焦虑障碍;急性前列腺炎	脑梗死##高脂血症##痛风##多发性神经病[多发性神经炎/周围神经炎]##睡眠障碍##焦虑障碍##急性前列腺炎	7
上呼吸道感染口腔溃疡,行动不便,关节痛,反酸痛风,冠心病预防血栓,高血压	上呼吸道感染##口腔黏膜溃疡##关节痛##反酸##痛风##冠状动脉粥样硬化性心脏病##高血压	7
2型糖尿病,高脂血症,高血压病,糖尿病伴神经并发症,糖尿病伴肾并发症,动脉硬化性心脏病,糖尿病伴眼并发症	2型糖尿病##高脂血症##高血压##2型糖尿病伴神经系统并发症##非胰岛素依赖型糖尿病伴有肾的并发症##动脉硬化性心脏病##非胰岛素依赖型糖尿病伴有眼的并发症	7
宫颈鳞癌IIb放化疗,化疗止吐保心保肝脱水利尿,消化不良，食欲减退，咳嗽咳痰	子宫颈恶性肿瘤##鳞状细胞癌##放射治疗##化学治疗##消化不良##食欲不振##咳嗽	7
左足底黑色素瘤扩大切除术后,左下肢肌肉间转移，肺、肝转移？,胃溃疡	足部恶性肿瘤##恶性黑色素瘤##下肢继发恶性肿瘤##肺继发恶性肿瘤##肝继发恶性肿瘤##胃溃疡##转移性恶性黑色素瘤	7
非霍奇金淋巴瘤,口腔溃疡,化疗期间白细胞减少,失眠伴焦虑抑郁状态	非霍奇金淋巴瘤##口腔黏膜溃疡##化学治疗##白细胞减少##失眠##焦虑状态##抑郁状态	7
直肠癌术后,腰痛,失眠,高血压,冠状动脉性心脏病	直肠术后##直肠恶性肿瘤##癌##腰痛##失眠##高血压##冠状动脉性心脏病	7
结肠癌术后pT4N1M0,肝转移切除术后	结肠术后##结肠恶性肿瘤##癌##肝继发恶性肿瘤##肝术后##转移性癌##淋巴结继发恶性肿瘤	7
右肺大细胞癌,骨转移,纵隔淋巴结转移,锁骨上淋巴结转移,刺激性咳嗽	右肺恶性肿瘤##大细胞癌##骨继发恶性肿瘤##转移性大细胞癌##纵隔淋巴结继发恶性肿瘤##锁骨上淋巴结继发恶性肿瘤##咳嗽	7
糖尿病,糖尿病伴肾并发症,高血压病,脑梗死,慢性肾衰竭,冠状动脉粥样硬化性心脏病,2型糖尿病伴多并发症	糖尿病##未特指的糖尿病伴有肾的并发症##高血压##脑梗死##慢性肾衰竭##冠状动脉粥样硬化性心脏病##非胰岛素依赖型糖尿病伴有多个并发症	7
非霍奇金淋巴瘤,上腔静脉压迫综合征,化疗期间,肝功能损害,白细胞减少,静脉血栓形成,上呼吸道感染，咳嗽	非霍奇金淋巴瘤##化学治疗##肝功能不全##白细胞减少##静脉血栓形成##上呼吸道感染##咳嗽	7
左乳腺癌肺骨转移放化疗	乳腺恶性肿瘤##癌##肺继发恶性肿瘤##骨继发恶性肿瘤##化学治疗##放射治疗##转移性癌	7
右下肺腺癌伴双肺、右肾上腺、骨转移 cT3N3M1 IV期 EGFR19号外显子缺失突变 ALK未测	右肺下叶恶性肿瘤##腺癌##骨继发恶性肿瘤##肺继发恶性肿瘤##肾上腺继发恶性肿瘤##转移性腺癌##淋巴结继发恶性肿瘤	7
非霍奇金淋巴瘤，NK/T细胞淋巴瘤,侵及左鼻腔及副鼻窦,鼻咽镜检查活检，局麻预防出血,化疗后骨髓抑制，白细胞减低,关节痛	非霍奇金淋巴瘤##鼻腔继发恶性肿瘤##鼻窦继发恶性肿瘤##化疗后骨髓抑制##白细胞减少##关节痛##转移性肿瘤	7
乙状结肠癌同时性肝转移IV期，化疗白细胞低 肝损害，消化不良，腹泻	乙状结肠恶性肿瘤##肝继发恶性肿瘤##化疗药物反应##白细胞减少##肝损害##消化不良##癌##转移性癌	8
尿毒症;肾性贫血;周围神经病;冠心病心律失常型;高血压;肾性贫血,高脂血症;原发性甲状腺机能减退	尿毒症##肾性贫血##多发性神经病[多发性神经炎/周围神经炎]##冠心病心律失常型##高血压##肾性贫血##高脂血症##原发性甲状腺功能减退	8
非霍奇金淋巴瘤 放化疗,胃淋巴瘤,上呼吸道感染,既往乙肝感染,白细胞低下,疼痛,口腔炎	非霍奇金淋巴瘤##恶性肿瘤放疗##化学治疗##胃淋巴瘤##上呼吸道感染##白细胞减少##疼痛##口炎	8
深静脉血栓形成,肺腺+130:400癌IV期,肝功能损伤,化疗呕吐,白细胞减少 中性粒细胞减少	静脉血栓形成##肺恶性肿瘤##腺癌##肝功能异常##化疗药物反应##呕吐##白细胞减少##中性粒细胞减少症	8
乙状结肠癌肝转移术后复发,肝转移,高血压病	乙状结肠恶性肿瘤##癌##肝继发恶性肿瘤##转移性癌##恶性肿瘤复发##肝继发恶性肿瘤##转移性癌##高血压	8
胰腺癌术后复发,疼痛,胰腺外分泌功能不足,梗阻性黄疸,消化道梗阻,危重病人长期不能进食	胰腺术后##胰腺恶性肿瘤##癌##恶性肿瘤复发##疼痛##手术后胰腺外分泌功能不全##梗阻性黄疸##进食障碍	8
行动不便,SLE，,上呼吸道感染、发热、咳嗽咳痰,咽痛,慢性便秘,高脂血症,高血压,预防血栓,肝肾阴虚、腰膝酸软	系统性红斑狼疮##上呼吸道感染##发热##咳嗽##咽痛##便秘##高脂血症##高血压	8
右肺腺癌IV期疼痛,特发性肺间质纤维化,2型糖尿病 高血压病 甲状腺结节 胆囊结石伴胆囊炎,便秘	右肺恶性肿瘤##疼痛##腺癌##特发性肺间质纤维化##2型糖尿病##高血压##胆囊结石伴胆囊炎##便秘	8
耳鸣;分泌性中耳炎;鼻中隔偏曲;慢性咽炎;鼻窦炎;头痛;脑血管供血不足;变应性支气管炎	耳鸣##分泌性中耳炎##鼻中隔偏曲##慢性咽炎##鼻窦炎##头痛##脑血管供血不足##支气管炎	8
胰腺癌放疗,肝转移? 血小板降低,化疗，食欲差	胰腺恶性肿瘤##恶性肿瘤放疗##肝继发恶性肿瘤##血小板减少##化学治疗##食欲不振##癌##转移性癌	8
胰尾癌术后复查,便秘,焦虑抑郁状态,癌性疼痛，无法口服止痛药,功能性消化不良	胰腺术后##胰尾恶性肿瘤##癌##便秘##焦虑障碍##抑郁状态##消化不良##癌性疼痛	8
胃窦癌腹腔广泛淋巴结转移,缺铁性贫血 巨细胞贫血 维生素缺乏,胃食管反流 消化道出血不除外,恶心、呕吐,长期不能进食	胃窦恶性肿瘤##癌##腹腔淋巴结继发恶性肿瘤##缺铁性贫血##维生素缺乏##胃食管反流##恶心##呕吐##进食障碍	9
食管癌,化疗呕吐反流性食管病,低钾血症水肿,行动不便,白细胞低,咳嗽	食管恶性肿瘤##化学治疗##呕吐##反流性食管炎##低钾血症##水肿##白细胞减少##咳嗽##癌	9
右侧乳腺癌术后 化疗,重度骨质疏松骨折 消肿止痛,右锁骨上淋巴结转移,关节痛，失眠	乳腺术后##乳腺恶性肿瘤##恶性肿瘤术后化疗##重度骨质疏松##骨折##锁骨上淋巴结继发恶性肿瘤##关节痛##失眠##癌	9
上呼吸道感染、发热、咳嗽咽痛,行动不便,感冒，胃溃疡,慢性便秘,过敏,慢性咽炎	上呼吸道感染##发热##咳嗽##咽痛##感冒##胃溃疡##便秘##过敏反应##慢性咽炎	9
尿毒症;高血压;冠心病心律失常型;高脂血症;糖尿病;肾性贫血;静脉血栓形成,透析中低血压	尿毒症##高血压##冠心病心律失常型##高脂血症##糖尿病##肾性贫血##静脉血栓形成##肾脏透析状态##低血压	9
左乳腺癌术后肝Ｍ,化疗呕吐，化疗后WBC小于2000,化疗肝损伤,失眠	乳腺术后##乳腺恶性肿瘤##肝继发恶性肿瘤##化学药物反应##呕吐##白细胞减少##肝损伤##失眠##癌	9
右頬部鳞癌放疗,慢性牙周炎,下肢软组织恶性肿瘤,慢性牙周炎,残根,深龋,牙列缺损,开口受限	颊部恶性肿瘤##鳞状细胞癌##恶性肿瘤放疗##慢性牙周炎##下肢软组织恶性肿瘤##慢性牙周炎##残留牙根##龋病##牙列缺损	9
左肾集合管癌,化疗后白细胞减少,发热,上呼吸道感染,咳嗽 痰中带血,化疗后血小板低	肾恶性肿瘤##集合管癌##化疗药物反应##白细胞减少##发热##上呼吸道感染##咳嗽##化疗药物反应##药物性血小板减少	9
小细胞肺癌晚期化疗,水肿利尿便秘食欲减退,肝功能损害肺部感染,咳嗽行动不便疼痛	肺恶性肿瘤##小细胞癌##化学治疗##水肿##便秘##食欲不振##肝功能异常##肺部感染##咳嗽##疼痛	10
冠心病高血压贫血高脂血症胃炎脑梗塞便秘脂肪肝心律失常上呼吸道感染	冠状动脉粥样硬化性心脏病##高血压##贫血##高脂血症##胃炎##脑梗死##便秘##脂肪肝##心律失常##上呼吸道感染	10
行动不便,慢性失眠,消化不良,呕吐,胃溃疡、反酸咽喉肿痛,感冒咽炎咳嗽咳痰,便秘,重度骨关节炎	失眠##消化不良##呕吐##胃溃疡##反酸##感冒##咽炎##咳嗽##便秘##重度骨关节病	10
鼻咽癌放化疗 骨肝转移，恶心呕吐，,失眠，食欲差,白细胞下降,免疫力下降,胸膜占位转移	鼻咽恶性肿瘤##恶性肿瘤放疗##化学治疗##骨继发恶性肿瘤##肝继发恶性肿瘤##恶心和呕吐##失眠##食欲不振##白细胞减少##胸膜继发恶性肿瘤##癌##转移性癌	11
左肾盂癌根治术后 IV期,膀胱转移根治术后,右输尿管皮肤造口术,盆腔局部复发,左侧髂外血管旁、左侧腹股沟区淋巴结转移,放疗,疼痛	肾盂恶性肿瘤##膀胱继发恶性肿瘤##膀胱术后##输尿管造口状态##盆腔恶性肿瘤##腹股沟淋巴结继发恶性肿瘤##恶性肿瘤放疗##疼痛##髂淋巴结继发恶性肿瘤##癌##转移性癌	11
右肺下叶小细胞肺癌 广泛期,食管胸中段癌食道溃疡狭窄,咳嗽 便秘化疗呕吐,食欲减退抗过敏,水肿利尿	右肺下叶恶性肿瘤##小细胞癌##食管胸中段恶性肿瘤##癌##食管溃疡##食管狭窄##咳嗽##便秘##化疗药物反应##呕吐##食欲不振##水肿	11
肺癌晚期术后复发放疗低硒,咯血,疼痛,咳嗽,恶心,呕吐	肺术后##肺恶性肿瘤##恶性肿瘤放疗##硒缺乏##咯血##疼痛##咳嗽##恶心##呕吐##恶性肿瘤复发##癌	11
宫颈癌放疗后,双肺多发结节 转移？ 骨转移T6压缩骨折,癌性疼痛,反流性食道炎,功能性便秘,躁郁症,风湿性关节炎,带状疱疹后神经痛	子宫颈恶性肿瘤##肺占位性病变##骨继发恶性肿瘤##胸椎压缩性骨折##反流性食管炎##便秘##双相情感障碍##风湿性关节炎##带状疱疹后神经痛##转移性癌##癌性疼痛	11
